Rk,Player,Nation,Pos,Squad,Age,Born,90s,Tkl,TklW,Def 3rd,Mid 3rd,Att 3rd,Tkl,Att,Tkl%,Lost,Blocks,Sh,Pass,Int,Tkl+Int,Clr,Err,Matches,-9999
1,Abner,br BRA,DF,Atl Paranaense,21,2000,23.4,43,28,26,14,3,24,38,63.2,14,18,3,15,39,82,54,0,Matches,7f9c5d2d
2,Adryelson,br BRA,DF,Botafogo (RJ),23,1998,16.1,17,12,14,3,0,8,10,80.0,2,18,12,6,22,39,99,0,Matches,e980e78d
3,Adson,br BRA,FWMF,Corinthians,21,2000,13.8,34,22,15,13,6,12,22,54.5,10,18,0,18,13,47,11,0,Matches,eda38706
4,Airton,br BRA,FW,Atl Goianiense,22,1999,19.3,32,24,17,8,7,15,39,38.5,24,17,5,12,10,42,12,0,Matches,751ef075
5,Carlos Alberto,br BRA,FWMF,América (MG),19,2002,1.7,1,1,1,0,0,1,4,25.0,3,2,0,2,4,5,0,1,Matches,08f48d96
6,Yuri Alberto,br BRA,FW,Corinthians,20,2001,16.1,12,8,1,6,5,6,13,46.2,7,15,0,15,2,14,8,0,Matches,65159211
7,Ale,br BRA,MF,América (MG),31,1990,21.4,50,21,20,22,8,19,37,51.4,18,32,5,27,28,78,36,1,Matches,b7d9347d
8,Alexandre Alemão,br BRA,FW,Internacional,23,1998,22.3,22,11,1,14,7,12,25,48.0,13,20,3,17,4,26,11,0,Matches,3ed2a79b
9,Alerrandro,br BRA,FW,Bragantino,22,2000,10.3,4,1,0,3,1,2,7,28.6,5,10,2,8,4,8,8,0,Matches,3415a44d
10,Alesson,br BRA,MFFW,Cuiabá,22,1999,11.4,19,9,8,8,3,11,33,33.3,22,20,1,19,3,22,3,0,Matches,611e984e
11,Alex,br BRA,DF,Santos,22,1999,3.7,4,3,2,2,0,3,4,75.0,1,8,8,0,8,12,15,0,Matches,7367baf7
12,Caio Alexandre,br BRA,MF,Fortaleza,22,1999,11.0,39,22,19,17,3,21,41,51.2,20,14,4,10,11,50,14,0,Matches,08ac23b7
13,Matheus Alexandre,br BRA,DF,Coritiba,22,1999,15.6,35,22,25,9,1,23,35,65.7,12,16,8,8,30,65,36,0,Matches,0212e748
14,Alexsander,br BRA,DF,Fluminense,18,2003,2.5,5,1,3,0,2,3,6,50.0,3,5,0,5,6,11,2,0,Matches,b13e7a78
15,Alisson,br BRA,MFFW,São Paulo,28,1993,10.5,15,9,4,9,2,10,22,45.5,12,10,1,9,5,20,8,0,Matches,99139fa4
16,Allan,br BRA,MF,Atlético Mineiro,24,1997,30.4,47,30,21,21,5,24,50,48.0,26,24,7,17,25,72,44,1,Matches,b15e93aa
17,Guilherme Almeida Augusto,br BRA,DF,Bragantino,29,1993,1.0,2,2,1,1,0,1,3,33.3,2,2,0,2,2,4,1,0,Matches,8eecd5f9
18,Henrique Almeida,br BRA,FW,América (MG),30,1991,16.6,18,11,4,9,5,4,15,26.7,11,7,0,7,3,21,9,0,Matches,8aa2f2e3
19,Júnior Alonso,py PAR,DF,Atlético Mineiro,28,1993,28.9,24,14,17,6,1,13,29,44.8,16,28,17,11,28,52,66,0,Matches,b18a3023
20,Diego Alves,br BRA,GK,Flamengo,36,1985,4.7,0,0,0,0,0,0,0,,0,0,0,0,0,0,0,0,Matches,12421a7c
21,Felipe Alves Raymundo,br BRA,GK,São Paulo,33,1988,17.0,0,0,0,0,0,0,0,,0,0,0,0,0,0,11,1,Matches,7fbe8689
22,Felipe Alves Raymundo,br BRA,GK,Juventude,33,1988,1.0,0,0,0,0,0,0,0,,0,0,0,0,0,0,1,0,Matches,7fbe8689
23,Rodrigo Alves Soares,br BRA,DF,Juventude,29,1992,31.0,38,25,25,9,4,29,53,54.7,24,22,5,17,13,51,77,1,Matches,4c1b67d6
24,Anderson,br BRA,GK,Atl Paranaense,23,1998,5.0,0,0,0,0,0,0,0,,0,0,0,0,0,0,7,1,Matches,29d862d4
25,Thonny Anderson,br BRA,MFFW,Coritiba,24,1997,8.1,25,17,6,14,5,12,29,41.4,17,9,4,5,5,30,9,0,Matches,7a7c9837
26,André,br BRA,MF,Fluminense,20,2001,33.5,55,38,22,30,3,24,59,40.7,35,36,12,24,36,91,20,1,Matches,ec604e2c
27,André,br BRA,FW,Cuiabá,31,1990,8.1,4,4,1,3,0,0,8,0.0,8,6,0,6,3,7,4,0,Matches,13b52dec
28,Andrey,br BRA,MF,Avaí,19,2002,0.3,0,0,0,0,0,0,0,,0,0,0,0,0,0,0,0,Matches,89c28d9f
29,Brayan Angulo,ec ECU,FWMF,Santos,26,1995,5.3,4,2,2,2,0,1,6,16.7,5,6,1,5,1,5,4,0,Matches,37fdc62b
30,Apodi,br BRA,MFFW,Goiás,35,1986,10.1,13,5,9,2,2,5,12,41.7,7,7,3,4,4,17,8,0,Matches,affbe6bc
31,Guilherme Arana,br BRA,DF,Atlético Mineiro,24,1997,19.1,22,16,13,7,2,9,16,56.3,7,15,6,9,10,32,25,0,Matches,2b15a82a
32,Willian Arão,br BRA,MFDF,Flamengo,29,1992,10.2,11,4,7,2,2,7,14,50.0,7,13,10,3,17,28,19,1,Matches,f47a530a
33,Michel Araujo,uy URU,FWMF,Fluminense,25,1996,0.9,5,3,2,2,1,2,4,50.0,2,2,0,2,0,5,0,0,Matches,1159e4ae
34,Robert Arboleda,ec ECU,DF,São Paulo,30,1991,8.0,8,6,6,2,0,6,7,85.7,1,10,7,3,6,14,52,0,Matches,269dbfc6
35,Jhon Arias,co COL,FWMF,Fluminense,24,1997,29.6,48,31,14,19,15,21,41,51.2,20,33,2,31,7,55,19,0,Matches,86d96066
36,Arthur,br BRA,MFDF,América (MG),18,2003,2.0,5,3,2,2,1,1,9,11.1,8,4,1,3,1,6,7,0,Matches,8a958856
37,Arthur,br BRA,FW,Corinthians,18,2003,0.0,0,0,0,0,0,0,0,,0,0,0,0,0,0,0,0,Matches,e93fed32
38,Artur,br BRA,FWMF,Bragantino,23,1998,31.0,29,18,12,11,6,13,34,38.2,21,32,8,24,15,44,16,0,Matches,105132cd
39,Eduard Atuesta,co COL,MF,Palmeiras,24,1997,7.3,12,7,4,7,1,3,17,17.6,14,10,1,9,10,22,2,0,Matches,60990b81
40,Felipe Augusto,br BRA,FW,Corinthians,17,2004,0.8,0,0,0,0,0,0,2,0.0,2,1,0,1,0,0,0,0,Matches,1f9cbd0b
41,Leo Augusto Pereira,br BRA,FWMF,Atl Goianiense,21,2000,12.6,24,16,9,12,3,8,29,27.6,21,17,2,15,10,34,5,0,Matches,a3818875
42,Renato Augusto,br BRA,MF,Corinthians,33,1988,15.6,30,15,10,11,9,10,24,41.7,14,13,1,12,14,44,9,1,Matches,83a6367a
43,Auremir,br BRA,MF,Goiás,30,1991,16.4,46,29,31,15,0,13,26,50.0,13,14,7,7,26,72,27,0,Matches,3a2e6d70
44,Auro,br BRA,DF,Santos,26,1996,4.3,9,6,5,3,1,5,10,50.0,5,3,1,2,3,12,11,0,Matches,b234cb0e
45,Danilo Avelar,br BRA,DF,América (MG),32,1989,9.6,11,8,7,3,1,5,14,35.7,9,11,4,7,16,27,36,1,Matches,eacb45fd
46,Felipe Azevedo,br BRA,MFFW,América (MG),35,1987,25.3,36,18,14,13,9,12,40,30.0,28,31,2,29,14,50,23,1,Matches,4a22b15a
47,Matheus Babi,br BRA,FWMF,Atl Paranaense,24,1997,0.9,1,1,0,0,1,0,0,,0,0,0,0,0,1,3,0,Matches,f48cff2c
48,Pedro Bahia,br BRA,MF,Goiás,19,2002,0.3,,0,,,,,,,,,,,0,,,,Matches,3964a23d
49,Fabrício Baiano,br BRA,FWMF,Fortaleza,29,1992,0.6,5,2,2,3,0,1,2,50.0,1,0,0,0,1,6,4,0,Matches,d8a48dad
50,Fabián Balbuena,py PAR,DF,Corinthians,30,1991,12.0,15,11,12,3,0,6,14,42.9,8,12,10,2,12,27,58,0,Matches,3626f7d9
51,Robson Bambu,br BRA,DF,Corinthians,24,1997,4.4,10,7,6,4,0,6,11,54.5,5,5,2,3,8,18,27,0,Matches,d4fa7d01
52,Léo Baptistão,br BRA,FWMF,Santos,29,1992,12.6,20,9,5,10,5,8,25,32.0,17,13,3,10,7,27,17,0,Matches,35f6db55
53,Gabriel Baralhas,br BRA,MF,Atl Goianiense,23,1998,24.0,52,37,26,21,5,19,59,32.2,40,30,10,20,35,87,29,0,Matches,b7838aad
54,Danilo Barbosa,br BRA,MF,Botafogo (RJ),25,1996,1.8,4,3,0,3,1,4,5,80.0,1,6,4,2,5,9,8,0,Matches,0557ff4f
55,Gabriel Barbosa,br BRA,FW,Flamengo,25,1996,22.7,10,5,2,5,3,5,18,27.8,13,0,0,0,2,12,2,0,Matches,72d0e1b6
56,Lucas Barbosa,br BRA,FWMF,Santos,20,2001,8.6,40,19,14,20,6,15,40,37.5,25,21,3,18,10,50,10,0,Matches,a28eac7e
57,Danilo Barcelos,br BRA,DFMF,Goiás,30,1991,11.4,20,17,13,5,2,8,20,40.0,12,12,5,7,11,31,28,0,Matches,26f4ef39
58,Leandro Barcia,uy URU,FW,Atl Goianiense,29,1992,0.3,2,2,1,1,0,2,3,66.7,1,0,0,0,2,4,1,0,Matches,11d91ea7
59,Barreto,br BRA,MF,Botafogo (RJ),26,1995,0.3,3,2,3,0,0,2,2,100.0,0,0,0,0,0,3,0,0,Matches,de08d383
60,Fellipe Bastos,br BRA,MF,Goiás,31,1990,9.6,23,11,6,14,3,9,28,32.1,19,15,2,13,11,34,24,0,Matches,9b99eae0
61,Ramiro Benetti,br BRA,MFFW,Corinthians,28,1993,6.1,13,7,5,7,1,4,8,50.0,4,9,1,8,6,19,5,0,Matches,96d14fe7
62,Martín Benítez,ar ARG,MF,América (MG),27,1994,8.4,7,6,2,2,3,3,11,27.3,8,12,1,11,5,12,7,0,Matches,c122e34e
63,Bento,br BRA,GK,Atl Paranaense,22,1999,33.0,1,1,1,0,0,1,1,100.0,0,0,0,0,1,2,11,2,Matches,5d699228
64,Lucas Beraldo,br BRA,DF,São Paulo,18,2003,1.4,4,4,4,0,0,2,4,50.0,2,0,0,0,2,6,6,0,Matches,b8aedf06
65,Eduardo de Biasi,br BRA,MF,Avaí,25,1997,20.8,47,19,18,27,2,25,58,43.1,33,12,4,8,12,59,16,0,Matches,828a04fa
66,Pedro Bicalho,br BRA,MF,Palmeiras,20,2001,0.0,1,1,1,0,0,1,1,100.0,0,0,0,0,0,1,0,0,Matches,f35cb8a4
67,Raul Bicalho,br BRA,DF,Corinthians,22,1999,18.7,28,15,23,5,0,16,25,64.0,9,20,12,8,32,60,63,1,Matches,79af412b
68,Guilherme Biro,br BRA,FW,Corinthians,17,2004,1.2,5,2,1,2,2,2,5,40.0,3,2,0,2,0,5,0,0,Matches,e38c2c76
69,Guilherme Biro,br BRA,DF,Coritiba,21,2000,8.2,15,12,11,3,1,8,12,66.7,4,5,1,4,14,29,19,0,Matches,02c7236e
70,Guilherme Bissoli,br BRA,FW,Avaí,24,1998,27.1,22,14,3,9,10,10,35,28.6,25,21,2,19,13,35,23,0,Matches,c9024e62
71,Marcelo Boeck,br BRA,GK,Fortaleza,37,1984,13.0,0,0,0,0,0,0,0,,0,0,0,0,1,1,6,0,Matches,069cb4f8
72,Vinícius Boff,br BRA,MF,Cuiabá,22,1999,0.1,0,0,0,0,0,0,0,,0,0,0,0,1,1,1,0,Matches,badaed00
73,Ângelo Borges,br BRA,FWMF,Santos,17,2004,17.0,14,6,3,6,5,3,10,30.0,7,18,0,18,6,20,6,0,Matches,737945d9
74,Daniel Borges,br BRA,DF,Botafogo (RJ),28,1993,20.8,38,18,27,11,0,20,43,46.5,23,13,3,10,17,55,45,0,Matches,71879f82
75,Douglas Borges,br BRA,GK,Botafogo (RJ),31,1990,1.0,0,0,0,0,0,0,0,,0,0,0,0,0,0,0,0,Matches,55196057
76,Marllon Borges,br BRA,DF,Cuiabá,29,1992,33.4,58,31,42,16,0,25,42,59.5,17,44,29,15,35,93,145,1,Matches,d0b29bbd
77,Gabriel Boschilia,br BRA,MFFW,Internacional,25,1996,0.6,1,1,0,1,0,0,4,0.0,4,1,0,1,0,1,1,0,Matches,e90af77c
78,Gabriel Boschilia,br BRA,MF,Coritiba,25,1996,5.3,6,3,3,1,2,3,11,27.3,8,3,2,1,6,12,2,0,Matches,e90af77c
79,Lucas Braga,br BRA,FWMF,Santos,25,1996,23.1,23,19,10,7,6,11,24,45.8,13,19,2,17,15,38,21,0,Matches,8a0a73ad
80,David Braz,br BRA,DF,Fluminense,34,1987,7.9,9,5,7,2,0,5,8,62.5,3,8,5,3,7,16,43,0,Matches,9313b408
81,Breno,br BRA,FW,Palmeiras,26,1996,3.7,8,2,1,3,4,2,3,66.7,1,1,0,1,1,9,3,0,Matches,e0016d00
82,Bressan,br BRA,DF,Avaí,29,1993,20.6,19,7,12,6,1,9,23,39.1,14,25,19,6,22,41,82,0,Matches,3db1684c
83,Emanuel Brítez,ar ARG,DF,Fortaleza,29,1992,20.0,48,32,28,18,2,31,45,68.9,14,23,10,13,30,78,77,0,Matches,fb29d05d
84,Bruninho,br BRA,MFFW,Juventude,21,2000,1.3,1,0,0,1,0,1,3,33.3,2,1,0,1,1,2,0,0,Matches,f7a3e78a
85,Bruno,br BRA,MF,Bragantino,18,2003,0.4,1,1,0,0,1,0,1,0.0,1,1,0,1,0,1,0,0,Matches,ad8c3404
86,Fabrício Bruno,br BRA,DF,Flamengo,25,1996,13.0,13,6,12,1,0,6,11,54.5,5,3,3,0,10,23,52,0,Matches,470d197b
87,Ricardo Bueno,br BRA,FW,Juventude,34,1987,9.0,10,8,1,7,2,2,12,16.7,10,8,2,6,0,10,15,0,Matches,768cbb2d
88,Vitor Bueno,br BRA,MFFW,Atl Paranaense,27,1994,12.5,8,5,3,5,0,2,13,15.4,11,15,2,13,7,15,13,0,Matches,5752f96d
89,Busanello,br BRA,DF,Juventude,23,1998,3.2,6,4,5,1,0,3,4,75.0,1,2,2,0,8,14,3,0,Matches,788c4780
90,Fabricio Bustos,ar ARG,DF,Internacional,25,1996,29.7,54,37,39,12,3,35,54,64.8,19,20,9,11,31,85,76,1,Matches,82549f54
91,Nahuel Bustos,ar ARG,FW,São Paulo,23,1998,3.2,3,2,0,3,0,1,3,33.3,2,2,0,2,0,3,0,0,Matches,8f774c7f
92,Daniel Cabral,br BRA,FW,Flamengo,19,2002,0.0,0,0,0,0,0,0,0,,0,0,0,0,0,0,0,0,Matches,c080bb5e
93,Patric Cabral Lalau,br BRA,DF,América (MG),32,1989,19.1,40,20,21,17,2,16,33,48.5,17,10,3,7,19,59,54,0,Matches,16cd17b7
94,Raúl Cáceres,py PAR,DF,América (MG),30,1991,18.0,35,19,19,10,6,20,45,44.4,25,17,7,10,17,52,28,0,Matches,6d9dc5be
95,Matheus Cadorini,br BRA,FW,Internacional,19,2002,1.0,1,0,0,1,0,0,1,0.0,1,2,1,1,0,1,1,0,Matches,7f2b23f8
96,Matheus Cadorini,br BRA,FW,Coritiba,19,2002,3.5,3,2,2,1,0,0,1,0.0,1,0,0,0,1,4,3,0,Matches,7f2b23f8
97,Caetano,br BRA,DF,Goiás,22,1999,24.6,32,19,24,7,1,15,28,53.6,13,26,21,5,37,69,111,0,Matches,226e5efd
98,Jonathan Cafu,br BRA,DFMF,Cuiabá,30,1991,6.2,10,6,6,4,0,4,7,57.1,3,4,0,4,1,11,1,0,Matches,8d043f1d
99,Rodrigo Caio,br BRA,DF,Flamengo,28,1993,6.5,9,4,6,3,0,4,8,50.0,4,7,6,1,8,17,24,0,Matches,186ed8f1
100,Calebe,br BRA,MFFW,Atlético Mineiro,21,2000,2.9,10,7,3,6,1,4,7,57.1,3,2,1,1,3,13,1,0,Matches,c84af55e
101,Lucas Calegari,br BRA,DF,Fluminense,19,2002,7.3,10,5,4,3,3,6,11,54.5,5,8,3,5,5,15,10,0,Matches,a564fe91
102,Jonathan Calleri,ar ARG,FW,São Paulo,28,1993,31.3,20,12,1,9,10,8,19,42.1,11,18,2,16,5,25,48,0,Matches,6922f806
103,Guilherme Camacho,br BRA,MF,Santos,31,1990,18.1,58,26,28,26,4,29,59,49.2,30,29,13,16,18,76,26,0,Matches,61a6775b
104,Nathan Camargo,br BRA,MFFW,Bragantino,16,2005,0.8,6,3,5,1,0,4,5,80.0,1,0,0,0,1,7,2,0,Matches,2c79da44
105,Camilo,br BRA,MF,Cuiabá,22,1999,18.5,29,22,9,14,6,13,31,41.9,18,20,8,12,26,55,46,2,Matches,dfb81359
106,Camutanga,br BRA,DF,Atl Goianiense,28,1993,0.8,2,2,1,1,0,2,5,40.0,3,0,0,0,2,4,2,0,Matches,c455a045
107,Luan Cândido,br BRA,DF,Bragantino,20,2001,29.2,34,21,18,14,2,22,47,46.8,25,21,9,12,32,66,85,0,Matches,ca151606
108,Germán Cano,ar ARG,FW,Fluminense,33,1988,34.2,17,6,6,8,3,9,25,36.0,16,11,3,8,8,25,24,0,Matches,9ccf4e14
109,Agustín Canobbio,uy URU,FW,Atl Paranaense,23,1998,15.6,31,16,12,15,4,16,34,47.1,18,19,0,19,7,38,7,0,Matches,4f5a2f38
110,Víctor Cantillo,co COL,MF,Corinthians,28,1993,10.2,21,12,10,8,3,12,25,48.0,13,11,4,7,12,33,17,0,Matches,45075f2f
111,Capixaba,br BRA,FWMF,Juventude,25,1997,18.4,41,27,27,10,4,25,39,64.1,14,18,1,17,19,60,19,0,Matches,ea2634a1
112,Juninho Capixaba,br BRA,DF,Fortaleza,24,1997,32.3,77,38,38,26,13,37,75,49.3,38,30,4,26,66,143,80,0,Matches,91ba7336
113,Gabriel Carabajal,ar ARG,MFFW,Santos,30,1991,5.5,5,4,3,2,0,1,8,12.5,7,8,1,7,3,8,5,0,Matches,7a694ae4
114,Johnny Cardoso,us USA,MF,Internacional,20,2001,15.7,39,22,16,18,5,18,49,36.7,31,23,10,13,39,78,30,0,Matches,7426f085
115,Igor Cariús,br BRA,DFMF,Cuiabá,28,1993,12.9,26,20,16,6,4,15,26,57.7,11,19,6,13,23,49,28,0,Matches,662475de
116,Joel Carli,ar ARG,DF,Botafogo (RJ),35,1986,4.1,4,2,4,0,0,3,4,75.0,1,3,2,1,5,9,31,0,Matches,00d6e369
117,Ed Carlos,br BRA,MF,Santos,20,2001,2.9,6,3,4,1,1,2,3,66.7,1,4,0,4,0,6,0,0,Matches,e93e479e
118,Jan Carlos Hurtado,ve VEN,FW,Bragantino,21,2000,5.4,5,1,0,3,2,1,6,16.7,5,3,1,2,3,8,0,0,Matches,f50b0b2b
119,João Carlos,br BRA,GK,Cuiabá,33,1988,10.6,0,0,0,0,0,0,0,,0,0,0,0,0,0,7,0,Matches,ad9e7995
120,Alan Carvalho,cn CHN,FWMF,Fluminense,32,1989,0.4,0,0,0,0,0,0,1,0.0,1,0,0,0,0,0,0,0,Matches,ebb2d232
121,Guilherme Carvalho,br BRA,MF,Ceará,22,1999,7.6,20,10,11,7,2,6,22,27.3,16,6,3,3,8,28,13,0,Matches,a32d25d3
122,Guilherme Carvalho,br BRA,MFDF,Atlético Mineiro,22,1999,1.6,6,3,4,1,1,1,6,16.7,5,3,0,3,1,7,4,0,Matches,a32d25d3
123,Cássio,br BRA,GK,Corinthians,34,1987,34.0,1,0,1,0,0,0,1,0.0,1,0,0,0,1,2,15,1,Matches,d42f6326
124,Luciano Castán,br BRA,DF,Coritiba,32,1989,35.0,31,17,22,7,2,19,31,61.3,12,53,43,10,35,66,144,4,Matches,0470eeba
125,Iury de Castilho,br BRA,FW,Ceará,26,1995,5.8,6,3,1,5,0,1,7,14.3,6,6,0,6,1,7,2,1,Matches,555311f2
126,Cauã,br BRA,DF,Juventude,18,2003,0.5,3,3,3,0,0,1,1,100.0,0,0,0,0,0,3,1,0,Matches,3c48a088
127,Matheus Cavichioli,br BRA,GK,América (MG),35,1986,25.0,1,1,1,0,0,1,1,100.0,0,1,0,1,2,3,18,0,Matches,8470f026
128,Brayan Ceballos,co COL,DF,Fortaleza,20,2001,11.9,18,9,10,7,1,8,16,50.0,8,11,6,5,14,32,55,1,Matches,3fa61ade
129,Murilo Cerqueira,br BRA,DF,Palmeiras,24,1997,31.5,38,21,27,9,2,21,41,51.2,20,51,25,26,39,77,102,0,Matches,10fe831e
130,Reynaldo Cesar Moraes,br BRA,DF,Goiás,25,1997,30.5,42,26,37,5,0,17,29,58.6,12,31,24,7,40,82,191,1,Matches,589d070c
131,Jhon Chancellor,ve VEN,DF,Coritiba,30,1992,13.0,14,7,12,2,0,7,13,53.8,6,10,9,1,9,23,56,0,Matches,84b6acaa
132,Arthur Chaves,br BRA,DF,Avaí,21,2001,16.5,18,15,12,6,0,9,12,75.0,3,22,19,3,13,31,71,1,Matches,913e4711
133,Renato Chaves,br BRA,DF,Juventude,31,1990,1.8,1,0,1,0,0,1,2,50.0,1,1,1,0,5,6,7,0,Matches,2a51efe8
134,Chico,br BRA,MFFW,Juventude,30,1991,24.2,54,31,21,23,10,19,39,48.7,20,24,4,20,25,79,21,0,Matches,bad7d8a9
135,Christian,br BRA,MF,Atl Paranaense,21,2000,4.8,8,6,1,6,1,4,8,50.0,4,3,1,2,5,13,4,0,Matches,a856b456
136,Diego Churín,ar ARG,FW,Atl Goianiense,32,1989,26.5,31,18,7,20,4,9,32,28.1,23,20,3,17,8,39,24,0,Matches,875ac6e9
137,Marcelo Cirino,br BRA,FW,Atl Paranaense,30,1992,5.2,5,3,1,2,2,2,6,33.3,4,7,0,7,5,10,5,0,Matches,6ba81b35
138,Léo Cittadini,br BRA,MFFW,Atl Paranaense,27,1994,8.0,18,10,9,8,1,7,15,46.7,8,9,0,9,5,23,12,0,Matches,68410185
139,Luccas Claro,br BRA,DF,Fluminense,30,1991,5.2,1,1,1,0,0,0,3,0.0,3,3,3,0,8,9,29,0,Matches,3cacc0ec
140,Clayton,br BRA,FWMF,Coritiba,23,1999,3.6,3,1,1,1,1,0,3,0.0,3,2,0,2,0,3,5,0,Matches,b05870de
141,Cléber,br BRA,FW,Ceará,25,1996,10.9,16,10,2,10,4,3,8,37.5,5,7,1,6,2,18,11,0,Matches,e539e239
142,Jean Cléber,br BRA,MF,Avaí,31,1990,9.6,16,11,10,5,1,9,12,75.0,3,10,3,7,13,29,9,1,Matches,16bf849a
143,Cleiton,br BRA,DF,Flamengo,18,2003,0.0,,0,,,,,,,,,,,0,,,,Matches,741c6251
144,Andrés Colorado,co COL,MF,São Paulo,23,1998,3.4,10,9,6,3,1,3,5,60.0,2,4,1,3,5,15,9,1,Matches,f3afff11
145,Germán Conti,ar ARG,DF,América (MG),27,1994,18.4,20,13,9,10,1,7,14,50.0,7,34,22,12,28,48,110,0,Matches,7b18b6db
146,Jonathan Copete,co COL,FW,Avaí,34,1988,3.1,5,2,0,4,1,2,4,50.0,2,4,0,4,3,8,6,0,Matches,ce070a45
147,Bruno Cortez,br BRA,DF,Avaí,34,1987,27.0,47,25,26,17,4,31,50,62.0,19,36,8,28,12,59,57,1,Matches,a3a1198a
148,Talles Costa,br BRA,MF,São Paulo,19,2002,6.1,11,8,3,8,0,6,11,54.5,5,7,0,7,8,19,3,0,Matches,d8f15d24
149,Lucas Crispim,br BRA,DFMF,Fortaleza,27,1994,13.0,18,13,9,5,4,14,21,66.7,7,12,0,12,15,33,18,0,Matches,6501ff61
150,Daniel Cruz,br BRA,FWDF,Botafogo (RJ),20,2001,0.1,1,1,1,0,0,0,1,0.0,1,0,0,0,0,1,1,0,Matches,86a118c2
151,Tomás Cuello,ar ARG,FW,Atl Paranaense,21,2000,18.0,44,25,21,17,6,16,40,40.0,24,15,2,13,12,56,10,0,Matches,5c8615dd
152,Víctor Cuesta,ar ARG,DF,Botafogo (RJ),33,1988,28.5,48,29,32,14,2,31,43,72.1,12,41,27,14,59,107,116,0,Matches,39fb428f
153,Andrés D'Alessandro,ar ARG,FW,Internacional,40,1981,0.8,0,0,0,0,0,0,0,,0,0,0,0,0,0,0,0,Matches,6a11048a
154,Adailson Dadá,br BRA,MFFW,Goiás,24,1997,27.9,38,22,24,10,4,13,42,31.0,29,23,2,21,15,53,20,0,Matches,2a75cc09
155,Daniel,br BRA,GK,Internacional,27,1994,23.0,0,0,0,0,0,0,2,0.0,2,0,0,0,1,1,8,3,Matches,636fc976
156,Danilo,br BRA,DF,Goiás,24,1997,2.6,1,0,1,0,0,1,2,50.0,1,6,5,1,2,3,13,0,Matches,415a34c5
157,Danilo,br BRA,MF,Palmeiras,20,2001,30.5,70,40,32,31,7,34,67,50.7,33,33,8,25,29,99,38,0,Matches,a816dbfb
158,David,br BRA,MF,Ceará,17,2004,0.1,0,0,0,0,0,0,0,,0,0,0,0,0,0,0,0,Matches,16a42430
159,David,br BRA,FW,Internacional,26,1995,9.1,12,6,5,4,3,2,9,22.2,7,7,1,6,0,12,7,0,Matches,92f9ace5
160,Kayke David,br BRA,FWMF,Flamengo,19,2003,0.3,1,0,0,1,0,0,0,,0,0,0,0,0,1,0,0,Matches,2285358d
161,Giorgian De Arrascaeta,uy URU,MF,Flamengo,27,1994,16.4,37,23,11,17,9,8,22,36.4,14,18,0,18,5,42,5,0,Matches,be8d02dd
162,Denilson,br BRA,MF,Cuiabá,20,2001,7.8,20,12,9,8,3,6,11,54.5,5,6,1,5,9,29,7,0,Matches,9144afdf
163,Dentinho,br BRA,FW,Ceará,33,1989,0.6,1,1,1,0,0,0,0,,0,2,0,2,0,1,0,0,Matches,85686f86
164,Dentinho,br BRA,FWMF,Avaí,24,1997,3.2,5,3,1,4,0,1,6,16.7,5,6,2,4,3,8,3,0,Matches,aaacc628
165,Valentín Depietri,ar ARG,FWMF,Fortaleza,21,2000,2.6,4,2,1,2,1,1,2,50.0,1,6,0,6,2,6,1,0,Matches,d02cb5d7
166,Deyverson,br BRA,FW,Cuiabá,30,1991,14.1,7,3,0,5,2,3,7,42.9,4,5,0,5,4,11,24,0,Matches,2e5e846d
167,Luan Dias,br BRA,MFFW,Goiás,24,1997,8.6,21,12,10,7,4,5,22,22.7,17,8,2,6,9,30,8,0,Matches,a342ce1e
168,Matheus Dias,br BRA,MF,Internacional,24,1997,1.2,6,2,4,2,0,2,4,50.0,2,6,3,3,1,7,1,0,Matches,ddfa9005
169,Juan Díaz,co COL,MF,Coritiba,20,2001,1.5,7,6,4,2,1,1,1,100.0,0,3,0,3,1,8,4,0,Matches,36839110
170,Diego,br BRA,MFDF,Ceará,33,1988,2.3,1,0,1,0,0,0,2,0.0,2,0,0,0,7,8,3,0,Matches,cd09e9a1
171,Diego,br BRA,GK,Atl Goianiense,23,1998,2.0,0,0,0,0,0,0,0,,0,0,0,0,0,0,0,0,Matches,6b023405
172,Diego,br BRA,DF,São Paulo,22,1999,19.1,36,25,23,11,2,15,27,55.6,12,19,10,9,24,60,63,0,Matches,7fb8f90c
173,Diego,br BRA,MF,Flamengo,36,1985,9.8,18,15,7,9,2,11,32,34.4,21,16,8,8,10,28,8,1,Matches,255a478a
174,Diego,br BRA,GK,Botafogo (RJ),23,1998,2.0,0,0,0,0,0,0,0,,0,0,0,0,0,0,1,1,Matches,6b023405
175,Dieguinho,br BRA,MFDF,Goiás,26,1995,32.1,65,39,29,27,9,26,59,44.1,33,41,16,25,35,100,85,0,Matches,7e5a7340
176,Dodô,br BRA,DF,Atlético Mineiro,29,1992,10.1,16,11,9,6,1,7,10,70.0,3,10,0,10,13,29,15,0,Matches,99931185
177,Matheus Donelli,br BRA,GK,Corinthians,19,2002,2.0,0,0,0,0,0,0,0,,0,0,0,0,0,0,0,0,Matches,7c736064
178,Renan dos Santos,br BRA,GK,Atl Goianiense,32,1989,16.0,0,0,0,0,0,0,2,0.0,2,0,0,0,0,0,17,2,Matches,6bfaecc4
179,Douglas,br BRA,DF,Bragantino,33,1988,0.8,,1,,,,,,,,,,,0,,,,Matches,e7fea035
180,Rodrigo Dourado,br BRA,MF,Internacional,27,1994,5.0,16,6,6,8,2,7,16,43.8,9,5,0,5,7,23,10,0,Matches,d7d05a22
181,David Duarte,br BRA,DF,Fluminense,27,1995,0.9,1,1,0,1,0,0,1,0.0,1,1,1,0,4,5,11,0,Matches,91bf16f7
182,Dudu,br BRA,FW,Palmeiras,30,1992,31.3,15,7,4,7,4,7,18,38.9,11,20,1,19,24,39,10,0,Matches,895ef5ec
183,Dudu,br BRA,DF,Juventude,19,2002,1.2,3,0,1,2,0,2,4,50.0,2,1,0,1,3,6,4,0,Matches,3f10ae0b
184,Pablo Dyego,br BRA,FW,Avaí,27,1994,5.4,11,7,9,1,1,5,12,41.7,7,7,2,5,6,17,5,0,Matches,fce54d7d
185,Edenílson,br BRA,MF,Internacional,32,1989,24.3,38,22,16,16,6,17,29,58.6,12,18,4,14,15,53,26,0,Matches,4e50f20e
186,Eder,br BRA,DF,América (MG),26,1995,32.7,23,13,16,7,0,14,28,50.0,14,46,35,11,54,77,153,0,Matches,ba1a2c4c
187,Éder,it ITA,FWMF,São Paulo,35,1986,7.4,5,5,1,1,3,1,5,20.0,4,4,1,3,1,6,1,0,Matches,5a325298
188,Edinho,br BRA,MF,Juventude,27,1994,4.1,,0,,,,,,,,,,,1,,,,Matches,a8cedcd9
189,Edson,br BRA,MFDF,Atl Goianiense,23,1998,9.1,19,12,12,5,2,13,17,76.5,4,13,6,7,10,29,17,0,Matches,644d4d85
190,Edson,br BRA,DFMF,Atl Goianiense,30,1991,15.8,25,15,14,11,0,11,19,57.9,8,29,17,12,27,52,77,2,Matches,041250aa
191,Carlos Eduardo,br BRA,MF,Botafogo (RJ),32,1989,12.2,16,10,5,7,4,6,15,40.0,9,6,1,5,10,26,14,1,Matches,1a234d32
192,Carlos Eduardo,br BRA,FWMF,Bragantino,25,1996,10.0,14,9,2,8,4,4,14,28.6,10,15,1,14,5,19,8,0,Matches,27c23008
193,Elton,br BRA,MF,Juventude,31,1990,12.9,29,18,17,10,2,15,25,60.0,10,14,5,9,20,49,19,0,Matches,42b5868b
194,Leandro Emmanuel Martínez,ar ARG,MF,América (MG),27,1994,2.9,10,6,3,3,4,2,3,66.7,1,3,0,3,3,13,1,0,Matches,74758396
195,Alan Empereur,br BRA,DF,Cuiabá,27,1994,24.7,18,9,12,5,1,5,11,45.5,6,18,15,3,38,56,89,1,Matches,825b8997
196,Endrick,br BRA,FW,Palmeiras,15,2006,3.4,4,4,1,1,2,1,1,100.0,0,3,0,3,0,4,0,0,Matches,a2728fbf
197,Erick,br BRA,MF,Atl Paranaense,24,1997,20.5,56,26,26,27,3,23,55,41.8,32,39,16,23,31,87,47,0,Matches,8a826636
198,Erick,br BRA,FWMF,Ceará,24,1997,11.7,10,5,6,3,1,4,19,21.1,15,11,0,11,5,15,5,0,Matches,8edcad0d
199,Erison,br BRA,FW,Botafogo (RJ),22,1999,16.5,4,3,0,2,2,2,9,22.2,7,5,0,5,1,5,10,0,Matches,a9c450cb
200,Estevão,br BRA,FWMF,Internacional,19,2002,1.2,2,1,2,0,0,2,2,100.0,0,2,1,1,1,3,0,0,Matches,149f4681
201,Lucas Evangelista,br BRA,MF,Bragantino,26,1995,29.0,60,36,22,33,5,28,55,50.9,27,24,10,14,27,87,36,0,Matches,5f4ce4b6
202,Everaldo,br BRA,MFFW,América (MG),27,1994,21.0,30,17,12,10,8,6,33,18.2,27,21,1,20,16,46,7,0,Matches,bdb57777
203,Éverson,br BRA,GK,Atlético Mineiro,31,1990,37.0,0,0,0,0,0,0,1,0.0,1,1,0,1,0,0,16,0,Matches,a59c090b
204,Éverton,br BRA,MFFW,Cuiabá,33,1988,4.4,7,6,2,5,0,5,14,35.7,9,5,0,5,4,11,3,0,Matches,f50a3570
205,Fabinho,br BRA,MF,Palmeiras,19,2002,0.8,3,3,0,2,1,1,4,25.0,3,0,0,0,2,5,2,0,Matches,ff0e595c
206,Fábio,br BRA,FWMF,Atlético Mineiro,24,1997,1.5,1,1,0,1,0,0,2,0.0,2,0,0,0,0,1,0,0,Matches,30f90535
207,Fábio,br BRA,GK,Fluminense,41,1980,38.0,2,1,2,0,0,1,2,50.0,1,0,0,0,0,2,14,1,Matches,15825726
208,Fabrício,br BRA,FWMF,Coritiba,24,1997,16.7,29,19,12,16,1,11,24,45.8,13,22,1,21,7,36,13,0,Matches,0211a29e
209,Fagner,br BRA,DF,Corinthians,32,1989,10.0,34,21,22,8,4,16,23,69.6,7,8,3,5,11,45,21,0,Matches,a9cc58fe
210,Willian Farias,br BRA,MF,Coritiba,32,1989,17.7,31,21,14,15,2,11,35,31.4,24,16,4,12,19,50,24,0,Matches,d1fcff2f
211,Lucas Fasson,br BRA,DF,Atl Paranaense,20,2001,0.8,0,0,0,0,0,0,0,,0,0,0,0,1,1,4,0,Matches,31ecbf29
212,Felipe,br BRA,MF,Fortaleza,27,1994,9.8,13,7,5,8,0,7,16,43.8,9,9,1,8,13,26,17,0,Matches,cadbabf9
213,Luis Felipe,br BRA,DF,Santos,28,1993,10.9,,9,,,,,,,,,,,18,,,,Matches,746c8624
214,Matheus Felipe,br BRA,DF,Atl Paranaense,23,1998,19.8,27,20,18,9,0,16,26,61.5,10,29,20,9,17,44,84,0,Matches,90749ab9
215,Lucas Fernandes,br BRA,MF,Botafogo (RJ),24,1997,18.6,19,10,5,11,3,10,35,28.6,25,19,5,14,8,27,8,0,Matches,a109d777
216,Matheus Fernandes,br BRA,MF,Atl Paranaense,23,1998,7.6,25,13,15,7,3,10,28,35.7,18,19,3,16,9,34,13,0,Matches,f76fdcd2
217,Gatito Fernández,py PAR,GK,Botafogo (RJ),33,1988,31.2,3,1,3,0,0,3,6,50.0,3,0,0,0,2,5,13,0,Matches,9a82f79a
218,Ignacio Fernández,ar ARG,MF,Atlético Mineiro,32,1990,24.7,47,24,14,18,15,21,70,30.0,49,32,2,30,21,68,7,0,Matches,97a17c0b
219,Rodrigo Fernández,uy URU,MF,Santos,26,1996,25.7,89,52,43,40,6,50,131,38.2,81,27,5,22,20,109,32,0,Matches,617ee116
220,Fernandinho,br BRA,MF,Atl Paranaense,36,1985,10.8,16,8,4,10,2,3,12,25.0,9,13,4,9,11,27,8,1,Matches,101da2b5
221,Derick Fernando,br BRA,DF,Santos,19,2002,0.2,0,0,0,0,0,0,0,,0,1,1,0,0,0,0,0,Matches,a19d96f6
222,Luiz Fernando,br BRA,FWMF,Atl Goianiense,25,1996,19.4,17,10,9,6,2,4,17,23.5,13,12,1,11,11,28,18,0,Matches,824ed016
223,Nahuel Ferraresi,ve VEN,DF,São Paulo,23,1998,7.9,18,11,12,6,0,9,17,52.9,8,16,7,9,12,30,30,0,Matches,719aab45
224,Luiz Filipe,br BRA,MFFW,Goiás,20,2001,0.4,4,1,2,1,1,1,1,100.0,0,1,1,0,0,4,0,0,Matches,4a615e0b
225,Flávio,br BRA,MF,América (MG),21,2000,0.3,2,2,2,0,0,2,3,66.7,1,0,0,0,2,4,0,0,Matches,f0367bfd
226,Rafael Forster,br BRA,DF,Juventude,31,1990,18.1,25,18,18,4,3,15,27,55.6,12,17,13,4,26,51,82,0,Matches,eb3f56e5
227,Matheus França,br BRA,FWMF,Flamengo,17,2004,7.5,15,5,5,8,2,5,6,83.3,1,4,0,4,3,18,8,0,Matches,077faf72
228,Fred,br BRA,FWMF,Fluminense,38,1983,1.4,1,0,0,0,1,1,1,100.0,0,0,0,0,0,1,3,0,Matches,acaeba74
229,Marlon Freitas,br BRA,MF,Atl Goianiense,26,1995,27.5,46,29,24,17,5,24,55,43.6,31,29,15,14,28,74,32,1,Matches,ae3181de
230,Douglas Friedrich,br BRA,GK,Avaí,33,1988,10.4,0,0,0,0,0,0,1,0.0,1,0,0,0,0,0,9,1,Matches,8789242d
231,Gabriel,br BRA,MF,São Paulo,22,1999,0.5,0,0,0,0,0,0,0,,0,1,0,1,0,0,0,0,Matches,135d500d
232,Gabriel,br BRA,MF,Internacional,29,1992,23.8,93,58,36,49,8,37,77,48.1,40,34,9,25,44,137,45,0,Matches,e9c0d5d8
233,Gabriel,br BRA,GK,Coritiba,29,1992,13.0,0,0,0,0,0,0,1,0.0,1,0,0,0,0,0,7,0,Matches,f93ed0df
234,Gabriel,br BRA,MF,Botafogo (RJ),28,1993,8.3,15,9,2,12,1,8,14,57.1,6,13,2,11,17,32,13,0,Matches,0d10333c
235,Eduardo Gabriel,br BRA,DF,Santos,25,1996,33.0,34,17,25,8,1,12,19,63.2,7,55,39,16,49,83,147,1,Matches,aed65960
236,Luiz Gabriel,br BRA,FWMF,Coritiba,19,2002,1.1,7,3,5,1,1,3,5,60.0,2,0,0,0,3,10,1,0,Matches,f9c619e0
237,Marquinhos Gabriel,br BRA,MFFW,Goiás,31,1990,8.4,10,6,3,5,2,5,7,71.4,2,8,1,7,1,11,2,0,Matches,fcd113c4
238,Vitor Gabriel,br BRA,FWMF,Juventude,22,2000,8.6,10,3,4,3,3,4,12,33.3,8,5,1,4,0,10,19,0,Matches,094c2abd
239,Matías Galarza,py PAR,MF,Coritiba,19,2002,6.7,24,9,5,14,5,11,30,36.7,19,11,3,8,13,37,4,0,Matches,8e97a57b
240,Matheus Galdezani,br BRA,MF,Avaí,29,1992,3.2,12,8,3,6,3,7,10,70.0,3,5,2,3,6,18,2,0,Matches,5042eb90
241,Thiago Galhardo,br BRA,FWMF,Fortaleza,32,1989,15.0,13,7,2,6,5,1,16,6.3,15,8,0,8,6,19,18,0,Matches,766f48dd
242,Giuliano Galoppo,ar ARG,MF,São Paulo,22,1999,7.9,16,11,2,10,4,6,19,31.6,13,8,0,8,3,19,5,0,Matches,a8eeadaf
243,Léo Gamalho,br BRA,FW,Coritiba,36,1986,18.4,12,6,3,5,4,4,11,36.4,7,4,2,2,0,12,12,0,Matches,f73056ee
244,Ganso,br BRA,MFFW,Fluminense,32,1989,27.5,40,22,12,20,8,13,38,34.2,25,22,4,18,9,49,9,0,Matches,23593121
245,García,br BRA,DFMF,Palmeiras,20,2002,1.1,2,0,2,0,0,0,0,,0,0,0,0,2,4,3,0,Matches,45d071f4
246,Bryan García,ec ECU,MF,Atl Paranaense,21,2001,3.1,4,4,1,3,0,2,13,15.4,11,3,0,3,2,6,7,0,Matches,7b66d351
247,Luan Garcia,br BRA,DF,Palmeiras,28,1993,13.6,15,4,10,4,1,8,14,57.1,6,14,8,6,22,37,53,1,Matches,6ebe6cc1
248,Gaspar,br BRA,FW,Avaí,19,2002,0.4,4,2,1,0,3,3,5,60.0,2,1,0,1,1,5,0,0,Matches,996af9a5
249,Rafael Gava,br BRA,MF,Cuiabá,28,1993,22.7,31,17,11,14,6,17,42,40.5,25,19,5,14,15,46,19,0,Matches,713e1a36
250,Lucas Gazal,br BRA,DF,Atl Goianiense,22,1999,14.5,9,4,9,0,0,5,6,83.3,1,16,12,4,16,25,79,0,Matches,dcae46d5
251,Guilherme Gehring,br BRA,MF,Juventude,16,2005,0.1,0,0,0,0,0,0,0,,0,0,0,0,0,0,0,0,Matches,37faab98
252,Geovane,br BRA,MF,Ceará,22,1999,6.1,11,4,1,8,2,5,11,45.5,6,11,4,7,5,16,4,0,Matches,099a14d5
253,Gil,br BRA,DF,Corinthians,34,1987,22.7,30,13,20,7,3,13,21,61.9,8,35,25,10,29,59,77,0,Matches,31edef00
254,Giovane,br BRA,FWDF,Corinthians,18,2003,3.3,6,2,1,4,1,2,4,50.0,2,5,2,3,1,7,1,0,Matches,1b567cdc
255,Giovani,br BRA,FWMF,Palmeiras,18,2004,0.4,0,0,0,0,0,0,0,,0,2,0,2,0,0,0,0,Matches,a199bd5f
256,Glédson,br BRA,GK,Avaí,38,1983,5.0,0,0,0,0,0,0,0,,0,0,0,0,0,0,1,0,Matches,a9d625f5
257,Diego Godín,uy URU,DF,Atlético Mineiro,35,1986,1.0,2,2,2,0,0,0,2,0.0,2,0,0,0,2,4,1,0,Matches,fc4f85b1
258,Bruno Gomes,br BRA,MF,Coritiba,20,2001,16.6,40,21,21,15,4,20,36,55.6,16,20,4,16,23,63,7,0,Matches,76f2bbf8
259,Igor Gomes,br BRA,MF,São Paulo,22,1999,22.9,26,13,10,12,4,8,25,32.0,17,12,2,10,18,44,12,0,Matches,6a7fb945
260,Igor Gomes,br BRA,DF,Internacional,20,2001,1.3,2,0,1,0,1,1,1,100.0,0,8,1,7,1,3,4,0,Matches,509d5b3d
261,João Gomes,br BRA,MF,Flamengo,20,2001,20.9,92,51,37,45,10,31,75,41.3,44,24,3,21,26,118,32,0,Matches,8b57ad2c
262,Gustavo Gómez,py PAR,DF,Palmeiras,28,1993,30.0,39,21,28,10,1,17,29,58.6,12,45,30,15,48,87,97,0,Matches,d5ce52a5
263,Aloísio dos Santos Gonçalves,cn CHN,FWMF,América (MG),33,1988,10.5,12,8,4,5,3,3,15,20.0,12,9,0,9,4,16,9,0,Matches,9851b2e0
264,Diego Gonçalves,br BRA,FW,Botafogo (RJ),27,1994,5.4,5,3,2,3,0,1,8,12.5,7,5,0,5,2,7,6,0,Matches,c707fc37
265,Matheus Gonçalves,br BRA,FW,Flamengo,16,2005,0.3,0,0,0,0,0,0,0,,0,1,0,1,0,0,0,0,Matches,071a6836
266,Ricardo Goulart,br BRA,MFFW,Santos,30,1991,4.5,3,3,2,0,1,0,1,0.0,1,2,0,2,1,4,6,0,Matches,f053730b
267,Daniel Guedes,br BRA,DFMF,Cuiabá,27,1994,8.8,15,9,6,6,3,8,23,34.8,15,9,2,7,15,30,10,0,Matches,25f61bc3
268,Roger Guedes,br BRA,FWMF,Corinthians,25,1996,28.3,8,3,1,3,4,1,6,16.7,5,7,1,6,3,11,10,0,Matches,612a9dd7
269,Paolo Guerrero,pe PER,FW,Avaí,38,1984,4.8,2,0,0,2,0,0,2,0.0,2,1,0,1,1,3,4,0,Matches,ae6657a1
270,Guga,br BRA,DF,Atlético Mineiro,23,1998,18.6,57,35,30,23,4,30,45,66.7,15,21,4,17,27,84,24,1,Matches,6975a3e1
271,Marcos Guilherme,br BRA,FWMF,São Paulo,26,1995,6.4,6,2,2,4,0,2,9,22.2,7,2,0,2,3,9,1,0,Matches,d5ff6084
272,Marcos Guilherme,br BRA,MF,Santos,26,1995,0.3,2,1,1,0,1,1,4,25.0,3,0,0,0,0,2,1,0,Matches,d5ff6084
273,Gustavinho,br BRA,MF,América (MG),20,2001,4.3,16,9,2,9,5,9,18,50.0,9,10,0,10,4,20,5,0,Matches,69896b0e
274,Habraão,br BRA,DF,Fortaleza,20,2001,2.4,5,2,4,1,0,4,5,80.0,1,9,8,1,1,6,20,0,Matches,1e329d13
275,Lucas Halter,br BRA,DF,Atl Paranaense,21,2000,1.1,0,0,0,0,0,0,1,0.0,1,2,0,2,2,2,6,0,Matches,7aa882a2
276,Lucas Halter,br BRA,DF,Goiás,21,2000,11.9,13,7,9,3,1,8,11,72.7,3,21,18,3,9,22,61,1,Matches,7aa882a2
277,Hayner,br BRA,DF,Atl Goianiense,26,1995,15.3,14,10,8,2,4,8,17,47.1,9,10,4,6,22,36,46,0,Matches,246c7429
278,Heitor,br BRA,DF,Internacional,21,2000,4.4,17,13,8,8,1,11,17,64.7,6,3,1,2,9,26,4,0,Matches,e0839492
279,Thiago Heleno,br BRA,DF,Atl Paranaense,33,1988,12.7,12,6,8,4,0,8,14,57.1,6,12,10,2,23,35,34,1,Matches,827422f9
280,Helinho,br BRA,FWMF,Bragantino,21,2000,19.0,28,15,15,8,5,16,33,48.5,17,28,1,27,19,47,20,0,Matches,5837cb60
281,Henrique,br BRA,DF,Coritiba,35,1986,17.9,19,12,16,3,0,13,18,72.2,5,30,25,5,21,40,71,0,Matches,429163de
282,Arthur Henrique,br BRA,DF,Atl Goianiense,27,1994,10.7,33,19,21,9,3,19,33,57.6,14,8,3,5,16,49,28,0,Matches,ae46bd26
283,Bruno Henrique,br BRA,FWMF,Flamengo,31,1990,6.8,12,8,4,6,2,4,9,44.4,5,5,0,5,4,16,7,0,Matches,5edff24f
284,Daniel Henrique,br BRA,FW,Ceará,17,2004,0.3,0,0,0,0,0,0,0,,0,0,0,0,0,0,0,0,Matches,1ef923db
285,Gustavo Henrique,br BRA,DF,Flamengo,28,1993,3.8,4,3,3,1,0,2,4,50.0,2,7,6,1,5,9,27,0,Matches,fa066690
286,Luis Henrique,br BRA,FWMF,Botafogo (RJ),20,2001,2.9,5,1,3,0,2,3,3,100.0,0,4,0,4,3,8,1,0,Matches,f36d5624
287,Luiz Henrique,br BRA,FWMF,Fluminense,21,2001,11.7,30,19,11,10,9,13,23,56.5,10,16,3,13,9,39,10,0,Matches,8059806f
288,Paulo Henrique,br BRA,DFMF,Juventude,25,1996,16.7,47,27,30,13,4,20,37,54.1,17,11,0,11,11,58,26,0,Matches,25a0cb08
289,Pedro Henrique,br BRA,DF,Atl Paranaense,26,1995,25.6,44,24,30,12,2,28,41,68.3,13,38,27,11,42,86,130,1,Matches,4322e5d7
290,Pedro Henrique,br BRA,FWMF,Internacional,31,1990,17.7,33,21,19,12,2,18,31,58.1,13,8,0,8,9,42,15,0,Matches,460976a2
291,Hércules,br BRA,MFFW,Fortaleza,21,2000,15.2,38,16,19,17,2,13,36,36.1,23,23,3,20,10,48,9,0,Matches,eadc7b45
292,Nicolás Hernández,co COL,DF,Atl Paranaense,24,1998,18.0,32,17,21,11,0,21,27,77.8,6,30,15,15,22,54,67,0,Matches,86046c18
293,Hugo,br BRA,DFMF,Goiás,24,1997,7.8,15,11,9,4,2,6,13,46.2,7,9,2,7,11,26,29,0,Matches,bd2593f3
294,Hugo,br BRA,DFMF,Botafogo (RJ),20,2001,12.2,30,19,18,9,3,16,26,61.5,10,15,1,14,20,50,27,0,Matches,de3dc682
295,José Hugo,br BRA,FWMF,Coritiba,22,1999,4.4,8,5,6,1,1,5,8,62.5,3,6,0,6,1,9,2,0,Matches,d0f01217
296,Victor Hugo,br BRA,MF,Flamengo,17,2004,13.9,24,11,7,13,4,10,26,38.5,16,8,3,5,11,35,20,0,Matches,33fca7f7
297,Vitor Hugo,br BRA,FW,Goiás,17,2004,0.0,0,0,0,0,0,0,0,,0,0,0,0,0,0,0,0,Matches,217f53a6
298,Hulk,br BRA,FW,Atlético Mineiro,35,1986,23.2,11,6,0,7,4,4,17,23.5,13,4,0,4,3,14,12,0,Matches,33a1f72e
299,José Hurtado,ec ECU,DF,Bragantino,20,2001,6.6,19,11,12,4,3,13,16,81.3,3,6,3,3,5,24,13,0,Matches,cb067e96
300,Hyoran,br BRA,MF,Bragantino,28,1993,14.2,22,16,9,9,4,7,21,33.3,14,17,3,14,10,32,7,0,Matches,ffb88c28
301,Igor,br BRA,MFFW,Flamengo,18,2003,0.3,4,0,3,1,0,0,1,0.0,1,1,1,0,0,4,0,0,Matches,fb19d550
302,André Inácio,br BRA,FW,Flamengo,19,2002,0.5,0,0,0,0,0,0,0,,0,1,0,1,0,0,0,0,Matches,cc77d69c
303,Mauricio Isla,cl CHI,DF,Flamengo,33,1988,3.8,3,3,1,2,0,3,3,100.0,0,3,1,2,6,9,6,0,Matches,de4517dd
304,Jadsom,br BRA,MF,Bragantino,20,2001,14.1,26,18,17,8,1,14,33,42.4,19,22,8,14,34,60,25,0,Matches,92859e80
305,Jadson,br BRA,MF,Juventude,28,1993,29.1,64,46,28,28,8,28,55,50.9,27,23,6,17,24,88,19,1,Matches,05748af4
306,Jailson,br BRA,GK,América (MG),40,1981,12.0,0,0,0,0,0,0,0,,0,0,0,0,0,0,6,0,Matches,01f7b8c3
307,Jair,br BRA,MF,Atlético Mineiro,27,1994,23.0,65,41,25,31,9,28,51,54.9,23,37,4,33,32,97,10,0,Matches,f3466edc
308,Jandrei,br BRA,GK,São Paulo,28,1993,18.3,0,0,0,0,0,0,0,,0,0,0,0,1,1,12,1,Matches,85ea4399
309,Vinícius Jaú,br BRA,MF,Avaí,23,1998,0.1,0,0,0,0,0,0,0,,0,0,0,0,0,0,0,0,Matches,192d3898
310,Pablo Javier García,uy URU,FW,Coritiba,22,1999,0.1,1,1,1,0,0,1,1,100.0,0,0,0,0,0,1,0,0,Matches,895321cd
311,Jean,br BRA,MF,Juventude,27,1994,13.1,48,30,24,20,4,31,61,50.8,30,21,11,10,39,87,35,0,Matches,69a34ec0
312,Jefferson,br BRA,DF,Atl Goianiense,25,1997,25.3,35,22,15,13,7,12,31,38.7,19,30,8,22,23,58,71,1,Matches,9df5f945
313,Jefferson,br BRA,FW,Botafogo (RJ),22,1999,17.8,30,16,9,12,9,13,41,31.7,28,24,2,22,12,42,4,0,Matches,45cce300
314,Jemerson,br BRA,DF,Atlético Mineiro,29,1992,11.1,18,8,10,7,1,10,14,71.4,4,9,4,5,10,28,33,0,Matches,7cab69b5
315,Jenison,br BRA,FW,Cuiabá,30,1991,3.6,1,1,0,1,0,0,2,0.0,2,3,0,3,2,3,5,0,Matches,767e6b7f
316,Alexandre Jesus,br BRA,MFDF,Fluminense,20,2001,0.7,0,0,0,0,0,0,0,,0,0,0,0,5,5,0,0,Matches,25a323f3
317,Jô,br BRA,FW,Ceará,34,1987,8.7,2,1,1,1,0,0,0,,0,4,1,3,2,4,13,0,Matches,e47d11f8
318,Jô,br BRA,FW,Corinthians,34,1987,2.2,1,1,0,0,1,0,2,0.0,2,1,0,1,1,2,7,0,Matches,e47d11f8
319,Joaquim,br BRA,DF,Cuiabá,23,1998,23.9,41,28,31,8,2,25,35,71.4,10,26,14,12,36,77,127,1,Matches,69e5e199
320,John,br BRA,GK,Santos,25,1996,1.0,0,0,0,0,0,0,0,,0,0,0,0,0,0,0,0,Matches,33a235af
321,Jonas,br BRA,MF,São Paulo,22,1999,0.3,0,0,0,0,0,0,0,,0,0,0,0,1,1,0,0,Matches,32794a5b
322,Felipe Jonatan,br BRA,DF,Santos,23,1998,23.0,28,17,16,11,1,16,23,69.6,7,13,7,6,34,62,70,0,Matches,0102ca7f
323,Jonathan,br BRA,DF,Botafogo (RJ),23,1998,0.5,1,1,0,1,0,1,2,50.0,1,0,0,0,1,2,0,0,Matches,f3f60814
324,Jorge,br BRA,DF,Palmeiras,25,1996,5.2,15,8,3,10,2,6,16,37.5,10,8,1,7,3,18,10,0,Matches,13c44fc5
325,Jorginho,br BRA,MF,Atl Goianiense,31,1991,18.2,33,18,11,13,9,10,28,35.7,18,16,1,15,6,39,26,0,Matches,1f809750
326,Jhojan Julio,ec ECU,FWMF,Santos,23,1998,9.2,24,13,11,9,4,4,17,23.5,13,11,2,9,9,33,5,0,Matches,b1fc89f5
327,Juninho,br BRA,MF,América (MG),35,1986,0.2,0,0,0,0,0,0,0,,0,0,0,0,0,0,0,0,Matches,2cc16e46
328,Juninho,br BRA,MF,América (MG),34,1987,34.5,45,28,20,17,8,19,39,48.7,20,46,14,32,31,76,34,0,Matches,7d10ca2e
329,Renato Junior,br BRA,FWMF,Goiás,19,2002,5.5,13,4,3,6,4,5,8,62.5,3,8,0,8,2,15,5,0,Matches,80b72720
330,Jussa,br BRA,MFDF,Fortaleza,25,1996,7.0,2,1,1,1,0,1,10,10.0,9,10,0,10,8,10,10,0,Matches,883f5dc8
331,Kaiky,br BRA,DF,Santos,18,2004,1.0,0,0,0,0,0,0,1,0.0,1,0,0,0,2,2,5,0,Matches,55634fb8
332,Lucas Kal,br BRA,MF,América (MG),25,1996,24.0,38,19,15,19,4,13,34,38.2,21,27,8,19,32,70,49,0,Matches,33ed689d
333,Kanu,br BRA,DF,Botafogo (RJ),24,1997,16.1,19,10,14,5,0,9,16,56.3,7,15,12,3,23,42,67,0,Matches,fefa9b9a
334,Alan Kardec,br BRA,FWMF,Atlético Mineiro,33,1989,2.9,1,1,1,0,0,0,1,0.0,1,3,0,3,0,1,2,0,Matches,e7fba767
335,Kauan,br BRA,FW,Bragantino,18,2003,0.3,0,0,0,0,0,0,0,,0,1,0,1,0,0,1,0,Matches,34375e0b
336,Kawê,br BRA,MFFW,América (MG),19,2002,0.3,0,0,0,0,0,0,2,0.0,2,1,0,1,0,0,1,0,Matches,f1bca9ec
337,Kayque,br BRA,MF,Botafogo (RJ),21,2000,3.1,6,5,1,5,0,1,7,14.3,6,6,0,6,2,8,1,0,Matches,54b980d6
338,Renato Kayser,br BRA,FW,Fortaleza,25,1996,1.8,2,0,2,0,0,1,4,25.0,3,2,0,2,0,2,1,0,Matches,c7495dda
339,Gabriel Kazu,br BRA,MF,Avaí,22,1999,0.0,0,0,0,0,0,0,0,,0,1,0,1,1,1,0,0,Matches,42430d76
340,Keiller,br BRA,GK,Internacional,25,1996,15.0,0,0,0,0,0,0,2,0.0,2,0,0,0,0,0,7,0,Matches,e38fde76
341,Thalisson Kelven,br BRA,DF,Juventude,23,1998,20.0,17,13,14,2,1,11,16,68.8,5,34,27,7,31,48,109,0,Matches,18e87471
342,Kelvi,br BRA,MF,Juventude,19,2002,0.5,2,1,0,2,0,1,1,100.0,0,0,0,0,0,2,1,0,Matches,33143d85
343,Kelvin,br BRA,MFFW,Atl Goianiense,24,1997,3.4,3,3,0,3,0,2,4,50.0,2,1,0,1,1,4,4,0,Matches,b8dab818
344,Kelvyn,br BRA,FWDF,Ceará,22,1999,0.6,1,1,0,1,0,1,1,100.0,0,0,0,0,0,1,1,0,Matches,8b992778
345,John Kennedy,br BRA,FWMF,Fluminense,19,2002,1.6,0,0,0,0,0,0,0,,0,0,0,0,1,1,0,0,Matches,132880e0
346,Keno,br BRA,FWMF,Atlético Mineiro,32,1989,20.6,42,20,11,20,11,15,29,51.7,14,28,4,24,3,45,8,0,Matches,98558c11
347,Kevin,br BRA,DF,Avaí,24,1997,29.2,61,40,37,20,4,31,67,46.3,36,32,7,25,37,98,73,1,Matches,1f07666f
348,Khellven,br BRA,DF,Atl Paranaense,20,2001,23.4,50,25,29,18,3,23,42,54.8,19,24,8,16,39,89,69,0,Matches,cf18ab1b
349,Willian Klaus,br BRA,DF,Atl Goianiense,28,1994,6.0,5,3,4,1,0,4,6,66.7,2,2,2,0,8,13,38,0,Matches,ddc86898
350,Willian Klaus,br BRA,DF,Botafogo (RJ),28,1994,1.0,0,0,0,0,0,0,0,,0,1,0,1,0,0,9,0,Matches,ddc86898
351,Benjamín Kuscevic,cl CHI,DF,Palmeiras,25,1996,3.3,10,4,7,3,0,3,3,100.0,0,2,1,1,9,19,4,0,Matches,9edddc34
352,Gabriel Lacerda,br BRA,DF,Ceará,22,1999,20.0,21,14,18,3,0,8,18,44.4,10,22,16,6,21,42,86,0,Matches,0664b5a6
353,Anthony Landazuri,ec ECU,DF,Fortaleza,24,1997,5.8,6,4,4,1,1,3,6,50.0,3,6,1,5,8,14,9,0,Matches,b3a267f0
354,Thauan Lara,br BRA,DFFW,Internacional,18,2004,3.8,8,6,8,0,0,6,6,100.0,0,4,0,4,4,12,9,0,Matches,c4dba1f3
355,Lázaro,br BRA,FWMF,Flamengo,19,2002,9.1,15,7,6,5,4,8,24,33.3,16,9,1,8,3,18,7,0,Matches,86ff856b
356,Anderson Leite,br BRA,MF,Juventude,28,1993,0.8,2,1,1,1,0,1,5,20.0,4,2,2,0,4,6,2,0,Matches,9981c92d
357,Vinícius Leite,br BRA,MF,Avaí,28,1993,1.5,4,2,0,3,1,4,6,66.7,2,2,1,1,6,10,0,0,Matches,e991fbd7
358,Bernardo Lemes,br BRA,MFFW,Coritiba,20,2002,10.5,33,15,13,18,2,20,32,62.5,12,10,4,6,16,49,17,0,Matches,1ee9a3b6
359,Marcos Leonardo,br BRA,FW,Santos,18,2003,32.0,4,2,0,3,1,1,11,9.1,10,11,1,10,2,6,33,0,Matches,3f47ebce
360,Vitor Leque,br BRA,MFDF,Juventude,21,2001,0.6,0,0,0,0,0,0,0,,0,0,0,0,0,0,0,0,Matches,6ba15719
361,Lima,br BRA,FWMF,Ceará,25,1996,21.5,39,23,9,23,7,19,50,38.0,31,26,5,21,18,57,13,0,Matches,d215c7de
362,Anderson Lima,br BRA,MFFW,São Paulo,22,1999,2.3,11,6,3,8,0,8,11,72.7,3,2,1,1,1,12,1,0,Matches,59be3a74
363,Lucas Lima,br BRA,DFMF,Atl Goianiense,21,2000,1.4,2,2,1,1,0,1,1,100.0,0,0,0,0,0,2,0,0,Matches,c4c45622
364,Lucas Lima,br BRA,MFFW,Fortaleza,31,1990,13.0,21,10,8,11,2,9,24,37.5,15,11,0,11,4,25,3,0,Matches,49d03337
365,Rodrigo Lindoso,br BRA,MF,Ceará,32,1989,9.6,13,7,3,8,2,6,17,35.3,11,14,6,8,7,20,15,0,Matches,7b013540
366,Liziero,br BRA,MF,Internacional,23,1998,5.6,24,12,17,7,0,10,19,52.6,9,12,1,11,7,31,8,0,Matches,318ecb8c
367,David Loiola,br BRA,DF,Ceará,19,2002,4.4,6,2,6,0,0,3,5,60.0,2,5,4,1,4,10,18,0,Matches,eddf365e
368,Marcelo Lomba,br BRA,GK,Palmeiras,35,1986,3.0,0,0,0,0,0,0,0,,0,0,0,0,0,0,1,0,Matches,e4835e3c
369,Kevin Lomónaco,ar ARG,DF,Bragantino,20,2002,12.4,10,6,7,3,0,6,9,66.7,3,12,6,6,9,19,34,1,Matches,dd5ddb83
370,José López,ar ARG,FW,Palmeiras,21,2000,6.1,5,2,0,2,3,1,6,16.7,5,5,2,3,1,6,6,0,Matches,e1426a52
371,Henrique Lordelo,br BRA,MFDF,Goiás,21,2000,1.4,5,4,2,3,0,2,2,100.0,0,4,1,3,2,7,2,0,Matches,b63394ba
372,Guillermo de los Santos,uy URU,DF,Coritiba,30,1991,10.5,14,12,11,3,0,9,12,75.0,3,17,10,7,17,31,53,0,Matches,1ac629b0
373,Luan,br BRA,MF,São Paulo,22,1999,1.8,2,1,2,0,0,0,2,0.0,2,1,0,1,3,5,1,0,Matches,12a226cf
374,Luan,br BRA,MF,Goiás,31,1990,0.5,1,1,0,0,1,0,2,0.0,2,1,0,1,0,1,0,0,Matches,22fc8906
375,Lucão,br BRA,GK,Bragantino,20,2001,1.0,0,0,0,0,0,0,0,,0,0,0,0,0,0,2,0,Matches,ebb5a0df
376,Lucas,br BRA,DF,Santos,20,2001,16.2,45,22,28,13,4,21,42,50.0,21,17,5,12,13,58,25,0,Matches,5d68f5b2
377,Ayrton Lucas,br BRA,DF,Flamengo,24,1997,28.4,63,39,28,33,2,36,60,60.0,24,26,10,16,27,90,52,1,Matches,db90b737
378,João Lucas,br BRA,DFMF,Cuiabá,23,1998,23.8,71,46,45,16,10,41,70,58.6,29,24,6,18,33,104,67,1,Matches,289dc81e
379,Luciano,br BRA,FW,São Paulo,28,1993,22.6,17,9,4,10,3,8,25,32.0,17,23,4,19,7,24,11,0,Matches,24ce161c
380,André Luis,br BRA,FWMF,Cuiabá,24,1997,20.4,23,13,9,11,3,7,24,29.2,17,16,4,12,7,30,10,0,Matches,821097f7
381,Filipe Luís,br BRA,DF,Flamengo,36,1985,7.1,20,12,7,9,4,10,12,83.3,2,7,1,6,12,32,10,0,Matches,e4ed2628
382,Victor Luis,br BRA,DF,Ceará,28,1993,15.7,17,9,7,9,1,6,20,30.0,14,11,7,4,15,32,30,0,Matches,cc68c4d3
383,David Luiz,br BRA,DF,Flamengo,34,1987,15.8,13,4,5,7,1,5,7,71.4,2,15,12,3,13,26,48,0,Matches,c0e27d1a
384,Luizão,br BRA,DF,São Paulo,19,2002,11.0,14,10,10,3,1,8,17,47.1,9,18,7,11,10,24,54,0,Matches,fb02fba4
385,Vinícius Machado,br BRA,GK,Ceará,21,2000,2.0,0,0,0,0,0,0,0,,0,0,0,0,0,0,0,0,Matches,0d9b2e53
386,Mádson,br BRA,DF,Santos,30,1992,23.8,37,25,20,17,0,21,32,65.6,11,26,18,8,32,69,59,2,Matches,766094be
387,Maguinho,br BRA,DFMF,Goiás,29,1993,21.6,41,26,24,10,7,18,31,58.1,13,19,11,8,34,75,68,0,Matches,d1c855c5
388,Gustavo Maia,br BRA,FW,Internacional,21,2001,0.2,0,0,0,0,0,0,0,,0,0,0,0,1,1,0,0,Matches,b36fed1d
389,Leonardo Maia,br BRA,MF,Bragantino,18,2003,0.3,,0,,,,,,,,,,,0,,,,Matches,a6f491e2
390,Pablo Maia,br BRA,MF,São Paulo,20,2002,22.8,41,19,24,17,0,20,44,45.5,24,36,9,27,21,62,29,1,Matches,3a243771
391,Thiago Maia,br BRA,MF,Flamengo,24,1997,17.2,44,26,17,21,6,22,45,48.9,23,18,7,11,24,68,27,0,Matches,91e58f66
392,Maicon,br BRA,DF,Santos,33,1988,21.3,29,20,22,7,0,23,36,63.9,13,38,25,13,29,58,113,1,Matches,2a8683b9
393,Iago Maidana,br BRA,DF,América (MG),25,1996,11.5,8,6,6,2,0,4,11,36.4,7,6,5,1,8,16,63,0,Matches,e65a5924
394,Léo Mana,br BRA,DF,Corinthians,17,2004,0.5,0,0,0,0,0,0,0,,0,0,0,0,3,3,1,0,Matches,d7a180bc
395,Alef Manga,br BRA,FWMF,Coritiba,27,1994,27.0,42,23,14,17,11,16,33,48.5,17,39,0,39,15,57,16,0,Matches,559782c4
396,Manoel,br BRA,DF,Fluminense,31,1990,27.2,22,12,11,11,0,13,21,61.9,8,26,21,5,22,44,93,1,Matches,12748e35
397,Gustavo Mantuan,br BRA,FWDF,Corinthians,20,2001,9.6,14,7,6,7,1,2,16,12.5,14,13,2,11,7,21,12,0,Matches,0d717632
398,Luis Manuel Orejuela,co COL,DF,Atl Paranaense,26,1995,13.0,25,14,15,7,3,15,26,57.7,11,8,2,6,10,35,28,0,Matches,e6a6379d
399,Maranhão,br BRA,FW,Botafogo (RJ),19,2002,1.0,,1,,,,,,,,,,,0,,,,Matches,617f236c
400,Willian Maranhão,br BRA,MFDF,Atl Goianiense,26,1995,14.8,25,12,9,12,4,15,23,65.2,8,19,11,8,22,47,48,1,Matches,f1d95c74
401,Willian Maranhão,br BRA,MF,Santos,26,1995,1.8,7,3,5,1,1,2,6,33.3,4,5,2,3,1,8,3,0,Matches,f1d95c74
402,Fernando Marçal,br BRA,DF,Botafogo (RJ),32,1989,17.1,38,21,22,13,3,17,35,48.6,18,23,5,18,34,72,38,0,Matches,9ae9eaea
403,Marcelo,br BRA,DF,Fortaleza,26,1996,29.0,34,20,22,11,1,21,39,53.8,18,36,27,9,52,86,150,0,Matches,300b455d
404,Marcinho,br BRA,FWMF,Avaí,26,1995,5.8,12,9,4,5,3,7,10,70.0,3,9,1,8,1,13,2,0,Matches,5465c7f9
405,Mariano,br BRA,DF,Atlético Mineiro,35,1986,19.2,43,30,21,18,4,24,55,43.6,31,17,1,16,23,66,28,1,Matches,e26f559f
406,Marinho,br BRA,FW,Flamengo,31,1990,15.3,26,12,10,10,6,11,26,42.3,15,14,1,13,7,33,6,1,Matches,c077c735
407,Rodriguinho Marinho,br BRA,FWMF,Cuiabá,33,1988,16.5,16,6,3,9,4,7,17,41.2,10,12,1,11,4,20,5,0,Matches,0e335a47
408,Marlon,br BRA,DF,América (MG),27,1994,24.3,57,37,36,18,3,31,50,62.0,19,33,14,19,44,101,60,0,Matches,a87b508e
409,Marlon,br BRA,DF,Fluminense,24,1997,3.0,5,4,3,1,1,4,6,66.7,2,2,2,0,5,10,14,0,Matches,63969d01
410,Marlon,br BRA,MFFW,Juventude,31,1990,4.5,5,2,2,2,1,1,11,9.1,10,6,0,6,6,11,7,0,Matches,455c6130
411,Marlos,ua UKR,MFFW,Atl Paranaense,33,1988,1.7,1,0,1,0,0,1,1,100.0,0,2,0,2,0,1,0,0,Matches,9139bb12
412,Felipe Marques,br BRA,FWMF,Cuiabá,32,1990,10.6,8,7,3,2,3,1,13,7.7,12,9,2,7,13,21,5,0,Matches,30139a1c
413,Gustavo Marques,br BRA,DF,América (MG),20,2001,0.5,0,0,0,0,0,0,0,,0,0,0,0,0,0,4,0,Matches,b4fce835
414,Marquinhos,br BRA,MF,São Paulo,18,2003,0.3,1,1,0,1,0,0,0,,0,0,0,0,0,1,1,0,Matches,59878425
415,Marquinhos,br BRA,FWMF,Cuiabá,25,1997,2.2,8,5,3,4,1,3,8,37.5,5,3,0,3,3,11,2,0,Matches,a9c95220
416,Marrony,br BRA,FWMF,Fluminense,22,1999,2.0,6,3,2,1,3,1,1,100.0,0,6,0,6,1,7,3,0,Matches,1dff86ec
417,Matheus Martinelli,br BRA,MF,Fluminense,20,2001,18.0,42,26,16,19,7,15,25,60.0,10,27,11,16,14,56,22,0,Matches,2b124c8c
418,Adrián Martínez,ar ARG,FWMF,Coritiba,29,1992,11.1,7,5,2,2,3,2,11,18.2,9,6,0,6,4,11,3,0,Matches,6c513f98
419,Matheus Martins,br BRA,FWMF,Fluminense,18,2003,17.8,30,15,8,13,9,5,18,27.8,13,16,4,12,10,40,11,0,Matches,73fd2787
420,Wellington Martins,br BRA,MF,Fluminense,31,1991,7.0,10,3,6,4,0,6,11,54.5,5,8,5,3,7,17,10,0,Matches,0430d656
421,Gonzalo Mastriani,uy URU,FW,América (MG),28,1993,5.2,2,2,0,1,1,1,4,25.0,3,4,0,4,0,2,4,0,Matches,b4339e2b
422,Mateusão,br BRA,FWMF,Flamengo,17,2004,2.5,1,0,0,1,0,0,2,0.0,2,1,0,1,0,1,5,0,Matches,78bee906
423,William Matheus,br BRA,DF,Juventude,31,1990,10.1,13,6,6,6,1,7,8,87.5,1,9,5,4,5,18,41,0,Matches,3498ddf4
424,Matheusinho,br BRA,MFFW,América (MG),23,1998,15.3,25,16,6,11,8,10,24,41.7,14,10,2,8,17,42,5,0,Matches,74f5a96d
425,Matheuzinho,br BRA,DF,Flamengo,21,2000,23.9,53,38,29,18,6,30,45,66.7,15,25,8,17,26,79,43,0,Matches,2a5bc0cd
426,Diego Matos,br BRA,DF,Avaí,25,1997,1.2,4,3,3,0,1,3,4,75.0,1,2,0,2,2,6,3,0,Matches,4b799458
427,Mauricio,br BRA,FWMF,Internacional,20,2001,17.4,19,8,5,9,5,6,23,26.1,17,10,1,9,16,35,10,0,Matches,bf4cbc22
428,Maycon,br BRA,MF,Corinthians,24,1997,8.8,12,3,8,3,1,8,26,30.8,18,9,3,6,11,23,10,1,Matches,005ca692
429,Mayke,br BRA,DFFW,Palmeiras,29,1992,16.3,34,20,14,14,6,14,31,45.2,17,20,4,16,30,64,27,0,Matches,47431289
430,Bruno Melo,br BRA,DFMF,Corinthians,29,1992,4.9,3,3,1,1,1,3,4,75.0,1,4,1,3,3,6,13,0,Matches,41ee21ae
431,Felipe Melo,br BRA,DFMF,Fluminense,38,1983,8.1,8,5,5,3,0,4,14,28.6,10,11,9,2,11,19,27,0,Matches,b14d84d3
432,Darlan Mendes,br BRA,MFFW,Juventude,23,1998,1.3,1,1,1,0,0,0,0,,0,0,0,0,1,2,0,1,Matches,a86f0d7b
433,Nathan Mendes,br BRA,DF,Coritiba,19,2002,5.0,8,6,4,3,1,6,9,66.7,3,2,2,0,6,14,17,0,Matches,c5aa7b35
434,Vitor Mendes,br BRA,DF,Juventude,22,1999,18.3,19,9,16,3,0,11,23,47.8,12,13,11,2,28,47,72,0,Matches,3cdbeab9
435,Bruno Méndez,uy URU,DF,Internacional,22,1999,4.8,7,3,5,1,1,6,8,75.0,2,7,5,2,6,13,15,0,Matches,66017b9d
436,Bruno Méndez,uy URU,DF,Corinthians,22,1999,12.6,29,19,21,8,0,15,26,57.7,11,21,8,13,18,47,31,0,Matches,66017b9d
437,Stiven Mendoza,co COL,FW,Ceará,29,1992,25.9,22,9,8,6,8,9,17,52.9,8,16,0,16,4,26,6,0,Matches,e68f2cb4
438,Ramon Menezes Roma,br BRA,DF,Atl Goianiense,26,1995,14.0,7,3,6,1,0,2,8,25.0,6,7,7,0,15,22,50,0,Matches,eab48ffb
439,Gabriel Menino,br BRA,MF,Palmeiras,21,2000,10.2,21,16,11,9,1,10,16,62.5,6,7,1,6,12,33,12,0,Matches,01819e70
440,Gabriel Mercado,ar ARG,DF,Internacional,34,1987,23.6,30,21,26,4,0,21,30,70.0,9,28,18,10,30,60,79,0,Matches,bf97c188
441,John Mercado,ec ECU,FW,Atl Paranaense,19,2002,0.0,0,0,0,0,0,0,0,,0,0,0,0,0,0,0,0,Matches,d97831ad
442,Miguel Merentiel,uy URU,FWMF,Palmeiras,25,1996,2.6,1,0,1,0,0,1,1,100.0,0,0,0,0,0,1,0,0,Matches,307224a2
443,Messias,br BRA,DF,Ceará,27,1994,23.0,11,8,7,4,0,7,10,70.0,3,27,17,10,23,34,115,0,Matches,70bb3170
444,Lucas Mezenga,br BRA,DF,Botafogo (RJ),20,2001,3.1,9,4,5,2,2,7,10,70.0,3,6,2,4,8,17,11,0,Matches,d62f5849
445,Michel,br BRA,DF,Ceará,31,1990,11.8,10,8,5,3,2,3,7,42.9,4,6,4,2,15,25,22,0,Matches,05384ea1
446,Carlos Miguel,br BRA,GK,Corinthians,23,1998,2.0,0,0,0,0,0,0,0,,0,0,0,0,0,0,0,1,Matches,84454067
447,Fernando Miguel,br BRA,GK,Fortaleza,36,1985,20.0,0,0,0,0,0,0,0,,0,0,0,0,0,0,4,2,Matches,f1f06658
448,Miranda,br BRA,DF,São Paulo,37,1984,12.8,18,15,16,2,0,11,18,61.1,7,17,9,8,13,31,67,0,Matches,314f2124
449,Paulo Miranda,br BRA,DF,Juventude,33,1988,16.4,6,4,6,0,0,2,5,40.0,3,21,18,3,22,28,89,0,Matches,93a194e1
450,Paulinho Moccelin,br BRA,MFFW,Juventude,27,1994,4.3,13,7,7,6,0,10,27,37.0,17,9,0,9,4,17,7,0,Matches,d63fb6a8
451,Moisés,br BRA,DF,Internacional,26,1995,6.5,8,8,5,3,0,6,7,85.7,1,3,1,2,6,14,18,0,Matches,a40af810
452,Moises,br BRA,FWMF,Fortaleza,25,1996,25.0,16,12,4,5,7,10,40,25.0,30,15,2,13,10,26,19,0,Matches,ddd07a25
453,Rodrigo Moledo,br BRA,DF,Internacional,34,1987,13.5,26,16,19,7,0,11,11,100.0,0,23,17,6,23,49,74,0,Matches,ce536c37
454,Jacob Montes,us USA,MF,Botafogo (RJ),23,1998,1.0,2,1,1,1,0,0,1,0.0,1,2,1,1,1,3,1,0,Matches,69678c84
455,Moraes,br BRA,DFMF,Juventude,24,1997,15.2,26,19,17,8,1,13,21,61.9,8,9,4,5,31,57,33,0,Matches,9b974a99
456,Airton Moraes,br BRA,GK,América (MG),27,1994,1.0,0,0,0,0,0,0,0,,0,0,0,0,0,0,0,0,Matches,5e8682b0
457,Júnior Moraes,ua UKR,FW,Corinthians,34,1987,4.5,5,4,1,2,2,1,4,25.0,3,4,1,3,2,7,0,0,Matches,c43e5e7e
458,Wesley Moraes,br BRA,FW,Internacional,25,1996,3.3,0,0,0,0,0,0,1,0.0,1,2,0,2,0,0,4,0,Matches,bfae110f
459,Morato,br BRA,FWMF,Avaí,29,1992,7.3,15,9,5,6,4,6,20,30.0,14,9,2,7,2,17,2,0,Matches,96b49b3b
460,João Moreira,pt POR,DF,São Paulo,17,2004,3.2,4,2,0,3,1,1,2,50.0,1,5,2,3,6,10,0,0,Matches,b3be99e3
461,Lucas Moreira,br BRA,MFFW,Cuiabá,21,2000,1.4,2,1,1,0,1,1,1,100.0,0,0,0,0,1,3,0,0,Matches,b9d412ff
462,Gustavo Mosquito,br BRA,FWMF,Corinthians,24,1997,12.6,14,4,4,5,5,7,13,53.8,6,4,1,3,4,18,11,1,Matches,c9ed46c4
463,Hugo Moura,br BRA,MF,Atl Paranaense,24,1998,19.4,40,23,21,19,0,21,50,42.0,29,29,5,24,43,83,27,0,Matches,14100165
464,Alex Muralha,br BRA,GK,Coritiba,32,1989,19.0,1,0,1,0,0,0,1,0.0,1,0,0,0,0,1,10,2,Matches,38082f12
465,Muriqui,br BRA,FWMF,Avaí,35,1986,14.3,20,6,4,14,2,9,24,37.5,15,11,0,11,10,30,5,0,Matches,a55ac46c
466,Andrey Ramos do Nascimento,br BRA,MF,Coritiba,23,1998,5.4,16,11,6,9,1,9,24,37.5,15,6,0,6,7,23,4,0,Matches,eb55ab5a
467,Matheus Nascimento,br BRA,FWMF,Botafogo (RJ),17,2004,6.8,7,4,3,1,3,1,7,14.3,6,7,1,6,1,8,6,0,Matches,e744c3de
468,Natan,br BRA,DF,Bragantino,20,2001,32.0,36,25,27,9,0,20,30,66.7,10,22,15,7,32,68,112,1,Matches,94bccc82
469,Natanael,br BRA,DF,Coritiba,20,2002,16.0,42,27,27,11,4,21,36,58.3,15,15,6,9,22,64,43,0,Matches,0b618504
470,Natanael,br BRA,DFFW,Avaí,31,1990,13.4,31,19,22,6,3,16,28,57.1,12,10,1,9,12,43,20,0,Matches,ed560575
471,Léo Natel,br BRA,FW,Corinthians,24,1997,0.3,1,0,0,1,0,1,1,100.0,0,0,0,0,0,1,0,0,Matches,cd8d04a2
472,Nathan,br BRA,DF,Santos,20,2001,6.9,15,7,9,6,0,11,20,55.0,9,7,2,5,9,24,15,0,Matches,9fb6420e
473,Nathan,br BRA,MF,Goiás,20,2001,0.0,0,0,0,0,0,0,0,,0,0,0,0,0,0,0,0,Matches,eb61284b
474,Nathan,br BRA,MFFW,Fluminense,25,1996,10.7,21,12,5,13,3,6,14,42.9,8,10,1,9,11,32,12,0,Matches,fa00f0c9
475,Nathan,br BRA,FWMF,Avaí,22,1999,1.1,3,3,1,2,0,1,3,33.3,2,0,0,0,0,3,0,0,Matches,e0d5a5e9
476,Rafael Navarro,br BRA,FWMF,Palmeiras,21,2000,8.0,15,9,2,9,4,2,7,28.6,5,6,0,6,0,15,2,0,Matches,4b5ab509
477,Kaiky Naves,br BRA,DFMF,Palmeiras,19,2002,0.4,0,0,0,0,0,0,0,,0,1,1,0,1,1,1,0,Matches,621576f9
478,Bruno Nazário,br BRA,MF,Juventude,26,1995,6.5,11,6,4,4,3,5,13,38.5,8,6,0,6,1,12,1,0,Matches,dc1d79a5
479,Neílton,br BRA,FWDF,Coritiba,27,1994,0.9,1,1,1,0,0,1,1,100.0,0,3,0,3,1,2,0,0,Matches,689299a6
480,Gabriel Neris,br BRA,MF,Juventude,20,2001,2.4,4,1,0,3,1,1,4,25.0,3,5,3,2,4,8,1,0,Matches,54fe5551
481,Gustavo Nescau,br BRA,FW,Cuiabá,21,2000,0.3,0,0,0,0,0,0,0,,0,0,0,0,0,0,1,0,Matches,0682693b
482,Rodrigo Nestor,br BRA,MF,São Paulo,21,2000,23.6,34,19,13,16,5,14,39,35.9,25,18,3,15,26,60,12,0,Matches,c04ebe99
483,Gabriel Neves,uy URU,MF,São Paulo,24,1997,6.3,13,11,6,6,1,8,22,36.4,14,7,1,6,9,22,11,0,Matches,2a03fb5f
484,Nicolas,br BRA,FWMF,Goiás,32,1989,11.1,10,3,3,5,2,4,13,30.8,9,8,3,5,4,14,24,0,Matches,0e74a520
485,Nikão,br BRA,FWMF,São Paulo,29,1992,5.8,2,1,1,1,0,0,6,0.0,6,2,0,2,1,3,4,0,Matches,a34bb194
486,Nino,br BRA,DF,Fluminense,24,1997,27.9,28,21,20,6,2,12,20,60.0,8,27,17,10,31,59,93,0,Matches,d4fa2207
487,Gabriel Noga,br BRA,DF,Atl Goianiense,20,2002,0.0,,0,,,,,,,,,,,0,,,,Matches,aa306af5
488,Ygor Nogueira,br BRA,DF,Juventude,26,1995,5.0,10,5,8,2,0,6,8,75.0,2,5,2,3,9,19,29,0,Matches,38466ef3
489,Nonato,br BRA,MF,Fluminense,23,1998,12.1,23,14,4,14,5,13,28,46.4,15,16,3,13,12,35,9,0,Matches,b91a6912
490,Nonoca,br BRA,MF,Avaí,23,1998,11.5,27,14,12,13,2,14,20,70.0,6,10,2,8,8,35,18,0,Matches,06c062d4
491,Gabriel Novaes,br BRA,FWMF,Bragantino,22,1999,4.3,6,2,1,2,3,1,1,100.0,0,2,1,1,2,8,1,0,Matches,297a324a
492,Thales Oleques,br BRA,DF,Avaí,27,1994,6.2,12,6,7,5,0,7,12,58.3,5,6,3,3,4,16,26,0,Matches,a30f8286
493,Bruno Oliveira,br BRA,MFFW,Santos,23,1998,5.0,7,4,1,3,3,3,16,18.8,13,3,0,3,2,9,3,0,Matches,d46904eb
494,Yuri Oliveira Lima,br BRA,MF,Juventude,27,1994,16.8,31,15,16,13,2,11,37,29.7,26,17,6,11,20,51,14,0,Matches,bcf3d64e
495,Pedro Oliveira,br BRA,MFFW,Goiás,17,2004,3.3,11,7,9,2,0,5,13,38.5,8,11,0,11,2,13,6,0,Matches,089b56d8
496,Leo Ortiz,br BRA,DF,Bragantino,26,1996,21.4,22,11,12,9,1,17,25,68.0,8,36,25,11,27,49,97,1,Matches,53834fa2
497,Kelvin Osorio,co COL,MFDF,Cuiabá,28,1993,10.5,21,14,11,10,0,13,30,43.3,17,8,0,8,8,29,16,0,Matches,1247ace9
498,Otávio,br BRA,MF,Atlético Mineiro,27,1994,12.9,34,19,16,17,1,14,32,43.8,18,22,3,19,12,46,13,1,Matches,243f4a0b
499,Luiz Otávio,br BRA,DF,Ceará,33,1988,21.2,33,21,24,9,0,13,26,50.0,13,30,19,11,48,81,77,0,Matches,ed976dd9
500,Rómulo Otero,ve VEN,MFFW,Fortaleza,29,1992,2.6,2,1,1,1,0,1,2,50.0,1,3,0,3,0,2,0,0,Matches,96fdc3c0
501,Luis Oyama,br BRA,MF,Botafogo (RJ),25,1997,12.0,31,17,17,11,3,17,44,38.6,27,19,4,15,17,48,14,1,Matches,ed0c094b
502,Pablo,br BRA,FW,Atl Paranaense,29,1992,16.6,12,10,2,6,4,1,4,25.0,3,9,2,7,11,23,27,0,Matches,1ad394c5
503,Pablo,br BRA,DF,Flamengo,30,1991,21.6,27,18,17,10,0,12,18,66.7,6,18,14,4,34,61,105,2,Matches,29d8ad3f
504,Juan Pablo,br BRA,DFMF,Goiás,19,2002,1.9,3,2,2,0,1,1,3,33.3,2,1,0,1,2,5,5,0,Matches,f40465af
505,Juan Pablo Ramírez,co COL,MFFW,América (MG),24,1997,4.5,7,3,1,5,1,3,5,60.0,2,3,0,3,4,11,2,0,Matches,20a17a29
506,Bruno Pacheco,br BRA,DF,Ceará,30,1991,26.1,,33,,,,,,,,,,,28,,,,Matches,9b7976e6
507,Igor Paixão,br BRA,FWMF,Coritiba,21,2000,17.2,13,9,4,7,2,4,15,26.7,11,9,2,7,15,28,11,0,Matches,089c7323
508,Pará,br BRA,MF,Juventude,19,2002,0.9,2,1,0,2,0,1,1,100.0,0,0,0,0,1,3,2,0,Matches,5b1cd0cc
509,Nino Paraíba,br BRA,DF,Ceará,36,1986,24.6,43,22,26,13,4,13,22,59.1,9,25,3,22,36,79,46,0,Matches,403ef062
510,Guilherme Parede,br BRA,FWMF,Juventude,26,1995,6.6,,2,,,,,,,,,,,3,,,,Matches,2da1c94c
511,Weslley Patati,br BRA,FW,Santos,18,2003,0.2,,0,,,,,,,,,,,0,,,,Matches,0df16cd7
512,Patrick,br BRA,MFFW,São Paulo,29,1992,21.8,64,36,31,18,15,28,57,49.1,29,31,2,29,13,77,14,0,Matches,92add14e
513,Alan Patrick,br BRA,MFFW,Internacional,30,1991,17.5,12,3,2,8,2,6,24,25.0,18,10,0,10,6,18,4,0,Matches,00672021
514,Luan Patrick,br BRA,DF,América (MG),20,2002,9.0,13,6,7,6,0,7,12,58.3,5,14,6,8,12,25,34,0,Matches,dd5d1c85
515,Patryck,br BRA,DF,São Paulo,19,2003,0.3,1,1,1,0,0,1,1,100.0,0,0,0,0,0,1,0,0,Matches,8dcbd7af
516,Giuliano de Paula,br BRA,MF,Corinthians,31,1990,18.4,20,13,8,12,0,12,40,30.0,28,15,2,13,10,30,16,0,Matches,ab1b205d
517,Patrick de Paula,br BRA,MF,Botafogo (RJ),22,1999,11.3,14,7,5,8,1,11,31,35.5,20,19,4,15,17,31,12,1,Matches,9f12fbb7
518,Paulão,br BRA,DF,Cuiabá,35,1986,8.0,1,1,0,1,0,1,4,25.0,3,7,4,3,8,9,53,0,Matches,20587790
519,Paulinho,br BRA,FWMF,América (MG),23,1998,3.2,3,1,0,2,1,1,2,50.0,1,2,0,2,0,3,1,0,Matches,bc486f0e
520,Paulinho,br BRA,MF,Corinthians,33,1988,1.8,2,0,1,1,0,0,0,,0,2,2,0,0,2,4,0,Matches,bb7337cc
521,Caio Paulista,br BRA,DF,Fluminense,23,1998,17.9,30,19,16,6,8,16,30,53.3,14,15,3,12,11,41,25,1,Matches,701bb051
522,Wellington Paulista,br BRA,FW,América (MG),37,1984,5.7,1,0,0,0,1,0,3,0.0,3,1,1,0,0,1,3,0,Matches,f2eece5b
523,João Paulo,br BRA,DF,América (MG),35,1986,3.9,10,5,4,5,1,4,9,44.4,5,5,2,3,7,17,7,0,Matches,ce208556
524,João Paulo,br BRA,GK,Santos,26,1995,37.0,3,2,3,0,0,2,3,66.7,1,0,0,0,2,5,15,1,Matches,d0102ca0
525,Marcos Paulo,br BRA,DF,Flamengo,19,2003,0.3,2,2,2,0,0,2,3,66.7,1,2,1,1,2,4,0,0,Matches,4dd6bb79
526,Cristian Pavón,ar ARG,FWMF,Atlético Mineiro,26,1996,7.7,12,7,4,3,5,9,20,45.0,11,13,0,13,3,15,2,0,Matches,a664b026
527,Pedrinho,br BRA,FWMF,América (MG),22,1999,10.8,11,6,5,5,1,5,25,20.0,20,9,0,9,8,19,7,0,Matches,035341ba
528,Pedrinho,br BRA,DFFW,Atl Paranaense,19,2002,15.4,21,13,11,8,2,13,24,54.2,11,18,2,16,27,48,51,1,Matches,64aadf6b
529,Pedrinho,br BRA,MFFW,Atlético Mineiro,23,1998,2.5,4,3,2,1,1,1,1,100.0,0,0,0,0,3,7,2,0,Matches,6796e284
530,Pedrinho,br BRA,FW,Flamengo,18,2003,0.1,0,0,0,0,0,0,0,,0,0,0,0,0,0,0,0,Matches,118d25ee
531,Pedro,br BRA,FW,Flamengo,24,1997,13.0,6,3,1,3,2,3,9,33.3,6,3,1,2,3,9,11,0,Matches,1ab6fad3
532,João Pedro,br BRA,DFFW,Corinthians,25,1996,1.3,2,0,1,1,0,1,1,100.0,0,3,3,0,1,3,9,0,Matches,31d1ed52
533,João Pedro Pepê,br BRA,MF,Cuiabá,24,1998,25.8,60,34,29,22,9,14,49,28.6,35,24,3,21,17,77,28,0,Matches,d75471eb
534,Peglow,br BRA,FWMF,Atl Goianiense,20,2002,2.6,5,4,2,1,2,3,9,33.3,6,4,0,4,4,9,3,0,Matches,8a861bc5
535,Pegorari,br BRA,GK,Juventude,30,1991,12.7,0,0,0,0,0,0,1,0.0,1,0,0,0,0,0,5,1,Matches,2ad9d2e3
536,Matheus Peixoto,br BRA,FW,Ceará,26,1995,5.2,6,3,1,4,1,2,6,33.3,4,4,2,2,2,8,4,0,Matches,05160796
537,Douglas Pelé,br BRA,FWDF,Goiás,22,1999,1.0,2,2,2,0,0,0,0,,0,2,0,2,1,3,1,0,Matches,7c6ac38f
538,Léo Pelé,br BRA,DF,São Paulo,25,1996,27.6,23,15,6,17,0,13,19,68.4,6,16,10,6,15,38,68,2,Matches,77980eb9
539,Carlos de Pena,uy URU,MFFW,Internacional,29,1992,29.3,44,26,14,22,8,27,50,54.0,23,30,2,28,54,98,36,0,Matches,6b915aa1
540,Andreas Pereira,br BRA,MF,Flamengo,26,1996,8.8,8,5,1,4,3,3,16,18.8,13,7,0,7,4,12,7,0,Matches,6639e500
541,Egídio Pereira Júnior,br BRA,DFMF,Coritiba,35,1986,14.0,33,13,19,11,3,15,47,31.9,32,16,2,14,20,53,22,2,Matches,6c5b3d31
542,Léo Pereira,br BRA,DF,Flamengo,26,1996,12.4,13,9,8,4,1,10,18,55.6,8,12,6,6,11,24,22,0,Matches,bd247251
543,Hernán Pérez,py PAR,FW,Coritiba,32,1989,1.1,2,0,1,1,0,2,6,33.3,4,1,1,0,0,2,0,0,Matches,e1cea3f7
544,Lucas Perri,br BRA,GK,Botafogo (RJ),24,1997,3.8,0,0,0,0,0,0,0,,0,0,0,0,0,0,1,0,Matches,5dbd461a
545,Petterson,br BRA,FWMF,Flamengo,18,2004,0.3,0,0,0,0,0,0,0,,0,0,0,0,0,0,0,0,Matches,9943597e
546,Yan Phillipe,br BRA,FW,Atlético Mineiro,17,2004,0.2,0,0,0,0,0,0,0,,0,1,0,1,0,0,0,0,Matches,03d01a35
547,Del Piage,br BRA,MF,Botafogo (RJ),21,2000,5.7,23,13,10,12,1,12,33,36.4,21,10,2,8,7,30,8,0,Matches,679ca46d
548,Lucas Piazon,br BRA,FWMF,Botafogo (RJ),28,1994,8.3,21,9,5,13,3,5,12,41.7,7,5,0,5,2,23,11,0,Matches,f201798c
549,Yago Pikachu,br BRA,DFMF,Fortaleza,29,1992,13.4,11,9,10,0,1,5,17,29.4,12,11,3,8,5,16,8,0,Matches,462f1e13
550,Mario Pineida,ec ECU,DF,Fluminense,29,1992,3.7,4,2,2,2,0,2,3,66.7,1,1,0,1,2,6,10,0,Matches,2990a468
551,Joaquín Piquerez,uy URU,DF,Palmeiras,23,1998,24.7,57,36,24,22,11,29,68,42.6,39,36,8,28,38,95,38,0,Matches,46009f44
552,Gabriel Pirani,br BRA,FWMF,Santos,19,2002,0.5,0,0,0,0,0,0,0,,0,1,0,1,0,0,0,0,Matches,17205abf
553,Gabriel Pirani,br BRA,MFFW,Cuiabá,19,2002,4.9,5,3,1,4,0,0,10,0.0,10,3,0,3,2,7,1,0,Matches,17205abf
554,Felipe Pires,br BRA,MFFW,Juventude,26,1995,7.4,3,1,0,1,2,1,3,33.3,2,3,0,3,0,3,2,0,Matches,2cd3d3ce
555,Rafael Pires,br BRA,GK,Atlético Mineiro,32,1989,1.0,0,0,0,0,0,0,0,,0,0,0,0,0,0,0,0,Matches,539f6761
556,Lucas Piton,br BRA,DFFW,Corinthians,21,2000,19.7,39,23,16,18,5,17,31,54.8,14,17,3,14,32,71,33,0,Matches,defce7f1
557,Isidro Pitta,py PAR,FW,Juventude,22,1999,26.8,11,6,2,5,4,8,12,66.7,4,10,3,7,4,15,16,0,Matches,e9fc7295
558,Luan Polli,br BRA,GK,Atl Goianiense,28,1993,2.0,0,0,0,0,0,0,0,,0,0,0,0,0,0,4,0,Matches,96aa89c4
559,Diego Porfirio,br BRA,DF,Coritiba,22,1999,5.0,12,6,4,6,2,7,13,53.8,6,3,1,2,5,17,15,0,Matches,8512d219
560,William Pottker,br BRA,FWMF,Avaí,28,1993,21.9,17,11,9,6,2,10,25,40.0,15,18,1,17,17,34,15,0,Matches,214a16c5
561,Bruno Praxedes,br BRA,MF,Bragantino,19,2002,6.5,6,3,0,5,1,1,6,16.7,5,4,1,3,4,10,2,0,Matches,5dd520a8
562,Erick Pulgar,cl CHI,MF,Flamengo,28,1994,3.9,8,3,2,6,0,3,8,37.5,5,8,1,7,3,11,8,0,Matches,4611e028
563,Jean Pyerre,br BRA,MF,Avaí,23,1998,8.4,9,4,3,6,0,3,8,37.5,5,8,0,8,7,16,1,0,Matches,b41dc073
564,Du Queiroz,br BRA,MF,Corinthians,22,2000,28.9,52,29,22,26,4,15,59,25.4,44,37,11,26,33,85,18,0,Matches,8440b0cb
565,Igor Rabello,br BRA,DF,Atlético Mineiro,26,1995,6.7,12,5,11,1,0,8,11,72.7,3,12,8,4,14,26,21,0,Matches,48048864
566,Rafael,br BRA,DF,Botafogo (RJ),31,1990,3.1,9,7,6,1,2,4,9,44.4,5,5,0,5,9,18,5,0,Matches,9a1f2e1c
567,Caio Rafael,br BRA,FW,Ceará,17,2004,0.4,0,0,0,0,0,0,0,,0,1,0,1,0,0,0,0,Matches,b7cda839
568,Léo Rafael,br BRA,FWMF,Ceará,20,2001,1.0,1,0,0,1,0,1,2,50.0,1,0,0,0,0,1,0,0,Matches,ef1df474
569,Zé Rafael,br BRA,MF,Palmeiras,28,1993,28.5,67,30,29,32,6,27,77,35.1,50,25,2,23,27,94,21,0,Matches,634b1413
570,Rafinha,br BRA,DF,São Paulo,36,1985,28.5,60,34,31,24,5,34,54,63.0,20,17,4,13,32,92,55,0,Matches,d003e213
571,Eric Ramires,br BRA,MFFW,Bragantino,21,2000,12.9,26,16,10,15,1,12,33,36.4,21,16,2,14,4,30,14,0,Matches,37faa4cb
572,Lucas Ramires,br BRA,DF,Juventude,19,2002,0.3,0,0,0,0,0,0,0,,0,0,0,0,0,0,1,0,Matches,32395c13
573,Ramon,br BRA,DF,Bragantino,20,2001,8.0,20,10,14,5,1,15,27,55.6,12,13,4,9,11,31,21,0,Matches,fdf88bc0
574,Lucas Ramos,br BRA,MFFW,Internacional,21,2001,0.9,2,0,1,1,0,1,1,100.0,0,2,0,2,2,4,0,0,Matches,c0163100
575,Rafael Ramos,pt POR,DF,Corinthians,27,1995,14.5,35,23,25,9,1,18,32,56.3,14,15,2,13,19,54,31,0,Matches,f8ddf51c
576,Raniele,br BRA,MFDF,Avaí,25,1996,31.3,61,33,30,25,6,30,63,47.6,33,56,25,31,39,100,106,1,Matches,a025365f
577,Wellington Rato,br BRA,FWMF,Atl Goianiense,29,1992,30.9,29,22,16,10,3,15,46,32.6,31,18,3,15,10,39,24,0,Matches,598917cf
578,Raul,br BRA,MF,Bragantino,25,1996,27.5,72,42,36,34,2,43,75,57.3,32,34,11,23,48,120,41,0,Matches,c2f9cf65
579,Pedro Raul,br BRA,FW,Goiás,25,1996,30.5,13,9,2,8,3,5,18,27.8,13,19,4,15,4,17,41,0,Matches,ed074559
580,Leonardo Realpe,ec ECU,DF,Bragantino,20,2001,7.4,7,3,5,2,0,5,9,55.6,4,11,8,3,15,22,34,0,Matches,57701cbd
581,Rafinha Rech,br BRA,FWMF,Juventude,19,2002,4.2,2,2,1,0,1,1,5,20.0,4,8,0,8,4,6,2,0,Matches,a8f19786
582,Régis,br BRA,MF,Coritiba,29,1992,8.5,18,10,6,8,4,8,20,40.0,12,10,0,10,1,19,4,0,Matches,0e2331f3
583,Reinaldo,br BRA,DFFW,São Paulo,32,1989,16.3,16,12,7,7,2,7,16,43.8,9,15,2,13,10,26,22,0,Matches,ab3edc87
584,César Reis,br BRA,GK,Juventude,26,1995,24.3,0,0,0,0,0,0,0,,0,0,0,0,0,0,11,1,Matches,76d4135b
585,Renan,br BRA,DF,Bragantino,19,2002,3.2,8,3,7,1,0,6,7,85.7,1,6,3,3,2,10,14,0,Matches,80c738be
586,Robert Renan,br BRA,DF,Corinthians,18,2003,10.0,17,11,11,5,1,11,15,73.3,4,8,5,3,19,36,51,0,Matches,168a2e81
587,Renato,br BRA,DFMF,Avaí,32,1990,11.3,14,9,6,7,1,9,12,75.0,3,13,2,11,8,22,24,0,Matches,8fe5bdcd
588,Renê,br BRA,DF,Internacional,29,1992,27.5,80,49,44,30,6,43,69,62.3,26,27,8,19,52,132,75,1,Matches,d000ffc7
589,Réver,br BRA,DF,Atlético Mineiro,37,1985,10.5,13,9,9,2,2,5,9,55.6,4,7,5,2,12,25,40,0,Matches,1938fd6a
590,Rhaldney,br BRA,MFFW,Atl Goianiense,23,1998,2.0,10,4,5,4,1,5,8,62.5,3,3,0,3,2,12,5,0,Matches,ae3ef77f
591,Everton Ribeiro,br BRA,MFFW,Flamengo,32,1989,19.9,44,20,18,16,10,13,44,29.5,31,22,2,20,19,63,6,1,Matches,68fb50a2
592,Lucas Ribeiro,br BRA,DFMF,Ceará,23,1999,5.6,5,0,3,2,0,0,3,0.0,3,3,2,1,9,14,12,0,Matches,607d64c6
593,Matheus Ribeiro,br BRA,DF,Avaí,28,1993,0.2,1,1,0,1,0,0,0,,0,1,1,0,0,1,0,0,Matches,7ae055bb
594,Wesley Ribeiro,br BRA,MFFW,Corinthians,16,2005,0.1,0,0,0,0,0,0,1,0.0,1,0,0,0,0,0,0,0,Matches,acf5672b
595,Ricardinho,br BRA,FW,Atl Goianiense,20,2001,2.6,0,0,0,0,0,0,2,0.0,2,2,0,2,0,0,0,0,Matches,45a1777c
596,João Ricardo Riedi,br BRA,GK,Ceará,33,1988,35.0,1,1,1,0,0,1,3,33.3,2,0,0,0,0,1,18,3,Matches,4729d71a
597,Vitor Ricardo,br BRA,DF,Fortaleza,21,2000,1.3,2,2,2,0,0,1,3,33.3,2,1,0,1,0,2,0,0,Matches,1f3906c9
598,Zé Ricardo,br BRA,MF,América (MG),25,1996,2.6,3,2,2,1,0,1,3,33.3,2,4,1,3,5,8,5,0,Matches,352f938e
599,Richard,br BRA,GK,Ceará,30,1991,1.0,0,0,0,0,0,0,0,,0,0,0,0,0,0,0,0,Matches,f2c12e8d
600,Richard,br BRA,MF,Ceará,27,1994,26.3,66,38,24,33,9,32,72,44.4,40,47,19,28,35,101,68,2,Matches,e90aa5da
601,Richardson,br BRA,MF,Ceará,30,1991,23.0,62,31,27,26,9,32,69,46.4,37,20,4,16,20,82,20,2,Matches,ef6b8a6b
602,Rickson,br BRA,MFFW,Atl Goianiense,23,1998,0.8,2,2,2,0,0,0,3,0.0,3,3,1,2,0,2,0,0,Matches,96a35d1b
603,Emiliano Rigoni,ar ARG,FWMF,São Paulo,28,1993,2.7,5,3,2,2,1,2,6,33.3,4,5,0,5,2,7,3,0,Matches,a1216563
604,Rikelme,br BRA,DF,Cuiabá,18,2003,0.2,1,0,0,1,0,1,1,100.0,0,1,0,1,1,2,0,0,Matches,637cdc49
605,Rikelmi,br BRA,DF,Botafogo (RJ),20,2001,0.0,0,0,0,0,0,0,0,,0,0,0,0,0,0,0,0,Matches,b2ffcf77
606,Cristian Rivas,ve VEN,MF,Cuiabá,25,1997,2.4,6,1,3,3,0,4,10,40.0,6,1,0,1,5,11,1,0,Matches,bc4d05c0
607,Zé Roberto,br BRA,FW,Ceará,28,1993,8.2,4,2,0,4,0,2,3,66.7,1,9,2,7,7,11,5,0,Matches,810033a1
608,Robinho,br BRA,MF,Coritiba,34,1987,9.8,34,17,15,13,6,18,36,50.0,18,3,0,3,6,40,2,0,Matches,8f8809b9
609,Robson,br BRA,FWMF,Fortaleza,30,1991,16.1,14,12,5,6,3,4,20,20.0,16,15,4,11,6,20,19,0,Matches,e29eff7a
610,Felipe Rocha,br BRA,FW,Avaí,19,2002,0.5,1,0,1,0,0,1,2,50.0,1,0,0,0,0,1,1,0,Matches,a961e1c4
611,Kaique Rocha,br BRA,DF,Internacional,20,2001,5.0,5,2,2,3,0,3,6,50.0,3,3,2,1,9,14,23,0,Matches,b31d385e
612,Marcos Rocha,br BRA,DF,Palmeiras,33,1988,25.0,87,54,36,43,8,37,70,52.9,33,28,8,20,31,118,42,0,Matches,fdd2f275
613,Pedro Rocha Neves,br BRA,FW,Atl Paranaense,27,1994,3.1,2,1,0,1,1,2,2,100.0,0,4,0,4,2,4,0,0,Matches,b33e0095
614,Pedro Rocha Neves,br BRA,FWMF,Fortaleza,27,1994,7.7,11,5,4,5,2,7,13,53.8,6,5,0,5,4,15,5,0,Matches,b33e0095
615,Rodinei,br BRA,DF,Flamengo,30,1992,9.8,26,17,8,14,4,16,18,88.9,2,7,3,4,13,39,6,0,Matches,7696cc85
616,Rodrigo,br BRA,FWMF,São Paulo,17,2004,0.8,1,1,0,1,0,0,4,0.0,4,1,0,1,0,1,0,0,Matches,1126f4e2
617,Rodrigo,br BRA,DF,Avaí,23,1998,5.3,3,2,3,0,0,3,5,60.0,2,5,5,0,10,13,18,0,Matches,cdfb04f5
618,Élton Rodrigues Brandão,br BRA,FW,Cuiabá,36,1985,3.3,3,1,2,1,0,1,3,33.3,2,3,0,3,0,3,3,0,Matches,e59be3c8
619,Raphael Rodrigues,br BRA,DF,Avaí,23,1999,1.4,1,0,1,0,0,0,0,,0,3,2,1,0,1,5,0,Matches,548640cf
620,Rodriguinho,br BRA,MF,América (MG),18,2003,2.1,4,3,2,2,0,1,7,14.3,6,1,0,1,5,9,0,0,Matches,4565dde3
621,Romarinho,br BRA,FWMF,Fortaleza,27,1994,14.6,13,11,3,7,3,7,21,33.3,14,5,0,5,4,17,7,0,Matches,1e7d2cc0
622,Braian Romero,ar ARG,FW,Internacional,30,1991,3.8,10,6,0,7,3,4,10,40.0,6,4,2,2,1,11,3,0,Matches,c5cc3130
623,Silvio Romero,ar ARG,FW,Fortaleza,33,1988,12.9,2,2,1,0,1,0,6,0.0,6,4,0,4,2,4,11,0,Matches,6a00c4b0
624,Rômulo,br BRA,FW,Atl Paranaense,19,2002,13.3,25,13,12,10,3,12,30,40.0,18,17,2,15,4,29,22,0,Matches,03dd053e
625,Romulo,br BRA,DF,Juventude,21,2000,1.9,3,1,3,0,0,2,4,50.0,2,4,3,1,2,5,5,0,Matches,395e0e95
626,Rômulo,br BRA,FWMF,Avaí,26,1995,4.7,5,4,0,4,1,2,3,66.7,1,6,1,5,5,10,3,0,Matches,9a6eb94c
627,Ronald,br BRA,MFFW,Fortaleza,24,1997,11.7,26,17,13,11,2,13,27,48.1,14,7,0,7,8,34,4,0,Matches,cc119c66
628,Ronaldo,br BRA,GK,Atl Goianiense,25,1996,18.0,3,0,3,0,0,3,3,100.0,0,2,0,2,0,3,8,0,Matches,711c08dc
629,Budiga Roni,br BRA,MF,Corinthians,22,1999,8.3,20,14,6,12,2,8,22,36.4,14,9,2,7,7,27,8,0,Matches,af433614
630,Rony,br BRA,FW,Palmeiras,26,1995,26.5,18,8,3,9,6,5,27,18.5,22,16,1,15,7,25,20,0,Matches,bffd5e50
631,Vitor Roque,br BRA,FW,Atl Paranaense,16,2005,14.6,17,9,4,6,7,4,9,44.4,5,10,0,10,9,26,1,0,Matches,cb00f1e6
632,Ruan,br BRA,FWMF,Juventude,16,2005,2.5,7,5,3,2,2,3,5,60.0,2,3,0,3,0,7,0,0,Matches,07c41bf4
633,Rubens,br BRA,DFMF,Atlético Mineiro,20,2001,13.7,63,31,31,24,8,26,43,60.5,17,17,1,16,21,84,28,0,Matches,ae23d044
634,Óscar Ruiz,py PAR,MFFW,Juventude,30,1991,11.0,11,7,4,6,1,4,9,44.4,5,9,0,9,5,16,8,0,Matches,620ce7b1
635,Rwan,br BRA,FWMF,Santos,20,2001,5.2,7,5,1,3,3,3,7,42.9,4,6,1,5,4,11,3,0,Matches,568a75fd
636,João Victor Santos Sá,br BRA,FW,Botafogo (RJ),27,1994,19.4,38,24,19,13,6,24,60,40.0,36,29,3,26,16,54,9,0,Matches,1a1033a1
637,Matheus Sales,br BRA,MFDF,Goiás,26,1995,19.9,42,24,22,15,5,18,30,60.0,12,34,17,17,16,58,45,0,Matches,c3c175c4
638,Philipe Sampaio,br BRA,DF,Botafogo (RJ),27,1994,12.5,12,8,8,4,0,10,17,58.8,7,16,15,1,27,39,65,0,Matches,72733d93
639,Carlos Sánchez,uy URU,MF,Santos,37,1984,8.7,12,8,5,4,3,5,16,31.3,11,10,2,8,5,17,4,0,Matches,a6dbad80
640,Sandry,br BRA,MF,Santos,19,2002,7.7,24,14,6,17,1,10,27,37.0,17,16,1,15,11,35,7,0,Matches,8ceeabef
641,Alex Santana,br BRA,MF,Atl Paranaense,26,1995,9.9,18,8,9,9,0,9,22,40.9,13,11,3,8,12,30,14,0,Matches,e75dc411
642,Santos,br BRA,GK,Flamengo,31,1990,19.0,0,0,0,0,0,0,0,,0,0,0,0,0,0,9,0,Matches,b8d0b69c
643,Ademir Santos,br BRA,FWMF,Atlético Mineiro,26,1995,16.6,29,18,14,7,8,13,42,31.0,29,27,2,25,8,37,8,0,Matches,4b7d58c2
644,Chayene Santos,br BRA,MFFW,Botafogo (RJ),31,1990,6.5,13,9,4,5,4,7,17,41.2,10,10,0,10,5,18,1,0,Matches,64a427b4
645,Fábio Santos,br BRA,DF,Corinthians,36,1985,17.4,21,15,9,10,2,16,32,50.0,16,18,5,13,19,40,48,0,Matches,d0d786fd
646,Guilherme Santos,br BRA,FWMF,Bragantino,20,2001,0.5,1,0,1,0,0,1,2,50.0,1,0,0,0,0,1,0,0,Matches,6eae9de6
647,Gustavo Santos,br BRA,FW,Avaí,19,2002,0.2,,0,,,,,,,,,,,0,,,,Matches,93913c8e
648,Juan Santos,br BRA,FW,São Paulo,19,2002,0.6,0,0,0,0,0,0,0,,0,2,1,1,0,0,0,0,Matches,ad89aa96
649,Júnior Santos,br BRA,FWMF,Botafogo (RJ),27,1994,11.9,16,13,11,4,1,6,16,37.5,10,16,0,16,2,18,13,0,Matches,9109e933
650,Luis Eduardo Marques dos Santos,br BRA,DF,Atl Goianiense,24,1997,18.2,36,19,25,6,5,27,45,60.0,18,28,12,16,26,62,44,1,Matches,5c5a0d4d
651,Matheus Santos,br BRA,MF,Goiás,23,1998,0.1,0,0,0,0,0,0,0,,0,1,0,1,0,0,0,0,Matches,48125180
652,Rafael Santos,br BRA,DF,Coritiba,23,1998,12.7,24,9,13,8,3,11,17,64.7,6,5,3,2,7,31,36,0,Matches,c72a6057
653,Mateus Sarará,br BRA,MF,Avaí,19,2002,4.8,8,3,3,3,2,4,6,66.7,2,6,4,2,4,12,12,0,Matches,1b4c1c9c
654,Renzo Saravia,ar ARG,DFMF,Botafogo (RJ),28,1993,20.2,48,31,30,16,2,33,70,47.1,37,27,5,22,32,80,36,2,Matches,cf316639
655,Eduardo Sasha,br BRA,FWMF,Atlético Mineiro,29,1992,14.3,8,6,4,4,0,3,8,37.5,5,12,1,11,6,14,7,0,Matches,b938b871
656,Lucas Sasha,br BRA,MF,Fortaleza,31,1990,14.1,66,46,30,33,3,24,47,51.1,23,22,5,17,20,86,35,1,Matches,2e2ec9cf
657,Gustavo Sauer,br BRA,FWMF,Botafogo (RJ),28,1993,3.2,6,3,2,3,1,3,9,33.3,6,5,0,5,1,7,1,0,Matches,fd53959e
658,Jefferson Savarino,ve VEN,FW,Atlético Mineiro,25,1996,1.0,1,1,1,0,0,0,0,,0,0,0,0,0,1,0,0,Matches,91721722
659,Sávio,br BRA,FWMF,Atlético Mineiro,17,2004,2.4,3,1,1,2,0,2,8,25.0,6,2,0,2,3,6,0,0,Matches,fe6e7156
660,Savio,br BRA,DF,Goiás,26,1995,9.4,20,12,16,3,1,12,25,48.0,13,5,1,4,6,26,24,0,Matches,3e8c6e2c
661,Gustavo Scarpa,br BRA,MFFW,Palmeiras,28,1994,28.6,18,10,8,8,2,3,21,14.3,18,9,1,8,13,31,15,0,Matches,2964fd20
662,Cleiton Schwengber,br BRA,GK,Bragantino,24,1997,37.0,1,1,1,0,0,0,3,0.0,3,1,0,1,0,1,25,5,Matches,d24ae824
663,Shaylon,br BRA,FWMF,Atl Goianiense,24,1997,15.0,17,9,7,6,4,6,17,35.3,11,12,1,11,5,22,9,0,Matches,69c11ef0
664,Sidcley,br BRA,DFMF,Cuiabá,28,1993,3.7,1,1,0,1,0,1,2,50.0,1,5,0,5,9,10,3,0,Matches,a5e96539
665,Sidimar,br BRA,DF,Goiás,29,1992,5.0,10,4,9,0,1,4,5,80.0,1,5,4,1,8,18,27,0,Matches,080fc1f0
666,Sidnei,br BRA,DF,Goiás,32,1989,3.3,3,3,3,0,0,2,3,66.7,1,1,1,0,7,10,20,0,Matches,b14d0c5d
667,Pablo Siles,uy URU,MF,Atl Paranaense,24,1997,1.8,5,1,1,1,3,4,8,50.0,4,4,3,1,3,8,0,0,Matches,cca1e0b5
668,Aderlan Silva,br BRA,DF,Bragantino,31,1990,29.7,94,62,45,35,14,46,92,50.0,46,40,11,29,45,139,60,1,Matches,48371573
669,Bruno Silva,br BRA,MF,Avaí,35,1986,28.9,88,52,43,40,5,43,96,44.8,53,48,8,40,30,118,60,0,Matches,6efbf91e
670,Da Silva,br BRA,DF,Goiás,20,2001,6.3,5,3,2,3,0,2,3,66.7,1,8,6,2,7,12,37,1,Matches,4772a037
671,Cristiano da Silva Leite,br BRA,DF,Fluminense,28,1993,8.3,15,8,5,6,4,8,10,80.0,2,5,1,4,10,25,13,0,Matches,2567b7b6
672,Felipe Silva Lipe,br BRA,DF,Avaí,19,2002,3.0,5,5,4,1,0,2,2,100.0,0,1,1,0,9,14,15,1,Matches,6b2bfcda
673,Lucas Silva,br BRA,FWMF,Avaí,24,1998,1.2,2,0,1,1,0,1,1,100.0,0,1,0,1,2,4,1,0,Matches,aa47c6ce
674,Marcão Silva,br BRA,MFDF,Cuiabá,31,1991,14.1,32,16,13,15,4,17,28,60.7,11,23,4,19,11,43,44,0,Matches,e7f8bf4a
675,Márcio Silva,br BRA,DF,Coritiba,20,2001,2.0,1,1,0,1,0,0,1,0.0,1,7,4,3,1,2,12,0,Matches,7ee2ea5b
676,Nathan Silva,br BRA,DF,Atlético Mineiro,24,1997,19.2,24,14,15,9,0,9,13,69.2,4,17,12,5,29,53,76,0,Matches,369d907c
677,Ricardo Silva,br BRA,DF,América (MG),29,1992,8.3,9,6,5,3,1,7,11,63.6,4,12,10,2,7,16,41,0,Matches,a5075276
678,Miguel Silveira,br BRA,MFFW,Bragantino,18,2003,6.3,12,6,6,2,4,5,15,33.3,10,9,0,9,1,13,2,0,Matches,281942c4
679,Vinicius Silvestre,br BRA,GK,Palmeiras,27,1994,1.0,0,0,0,0,0,0,0,,0,0,0,0,0,0,0,0,Matches,1944518a
680,Jailson Siqueira,br BRA,MF,Palmeiras,26,1995,0.2,0,0,0,0,0,0,2,0.0,2,0,0,0,0,0,0,0,Matches,b4819112
681,Everton Soares,br BRA,FWMF,Flamengo,25,1996,15.7,22,13,3,9,10,6,12,50.0,6,8,0,8,6,28,2,0,Matches,b1cbc666
682,Tiquinho Soares,br BRA,FW,Botafogo (RJ),31,1991,13.7,7,4,0,7,0,5,7,71.4,2,3,1,2,2,9,13,0,Matches,4d982baf
683,Fernando Sobral,br BRA,MF,Ceará,27,1994,11.2,27,22,17,7,3,16,36,44.4,20,20,5,15,4,31,14,0,Matches,c012aacd
684,Yeferson Soteldo,ve VEN,FWMF,Santos,24,1997,6.3,5,0,0,3,2,3,12,25.0,9,1,0,1,1,6,0,0,Matches,bbb6c951
685,Yan Souto,br BRA,DF,Goiás,20,2001,6.8,6,4,4,2,0,3,7,42.9,4,11,9,2,11,17,49,0,Matches,2dffc479
686,Hugo Souza,br BRA,GK,Flamengo,23,1999,14.3,1,1,1,0,0,1,2,50.0,1,0,0,0,1,2,7,1,Matches,c02e5af1
687,Igor Vinícius de Souza,br BRA,DFFW,São Paulo,24,1997,12.9,42,24,20,15,7,18,37,48.6,19,11,3,8,12,54,13,0,Matches,ec95088d
688,Bruno Tabata,br BRA,FW,Palmeiras,24,1997,5.2,,5,,,,,,,,,,,2,,,,Matches,33fdf90d
689,Tadeu,br BRA,GK,Goiás,29,1992,38.0,0,0,0,0,0,0,0,,0,2,0,2,2,2,17,0,Matches,8445554f
690,Tailson,br BRA,FWDF,Santos,22,1999,0.4,1,0,0,1,0,0,1,0.0,1,0,0,0,1,2,0,0,Matches,200b381d
691,Taison,br BRA,MFFW,Internacional,34,1988,8.1,8,7,3,5,0,5,15,33.3,10,5,0,5,7,15,3,0,Matches,7272a72a
692,Tchê Tchê,br BRA,MF,Botafogo (RJ),29,1992,25.7,29,18,9,20,0,9,32,28.1,23,15,3,12,27,56,16,1,Matches,5f2caf8f
693,David Terans,uy URU,MF,Atl Paranaense,27,1994,22.3,19,10,4,12,3,6,21,28.6,15,10,0,10,5,24,1,0,Matches,d3d89d8d
694,Miguel Terceros,bo BOL,FW,Santos,17,2004,0.3,1,1,0,1,0,1,1,100.0,0,0,0,0,0,1,0,0,Matches,d66ed604
695,Thiago,br BRA,GK,São Paulo,22,1999,2.7,0,0,0,0,0,0,0,,0,0,0,0,0,0,0,1,Matches,602d20ae
696,Guilherme Tinga,br BRA,DF,Fortaleza,28,1993,13.1,32,17,22,9,1,21,28,75.0,7,10,7,3,19,51,49,0,Matches,a8331ab0
697,Titi,br BRA,DF,Fortaleza,33,1988,31.1,32,21,24,8,0,20,31,64.5,11,15,14,1,43,75,84,0,Matches,ea41ddf7
698,Igor Torres,br BRA,FWMF,Fortaleza,21,2000,0.1,1,0,1,0,0,1,1,100.0,0,0,0,0,0,1,0,0,Matches,cc9b11b1
699,Jesús Trindade,uy URU,MF,Coritiba,28,1993,14.6,34,17,17,15,2,16,34,47.1,18,15,4,11,10,44,12,0,Matches,066e9f5d
700,Bruno Tubarão,br BRA,FWMF,Bragantino,26,1995,5.0,8,3,3,2,3,3,12,25.0,9,3,0,3,6,14,2,0,Matches,5411ef4f
701,Uendel,br BRA,DF,Cuiabá,33,1988,14.7,19,8,13,6,0,13,23,56.5,10,14,0,14,10,29,27,0,Matches,0bd9e045
702,Valdemir,br BRA,MF,Coritiba,24,1997,6.9,20,12,15,4,1,13,23,56.5,10,8,3,5,9,29,11,0,Matches,82cca681
703,Valdívia,br BRA,MFFW,Cuiabá,27,1994,15.4,19,10,9,8,2,5,18,27.8,13,9,1,8,8,27,8,0,Matches,e12be458
704,Vanderlan,br BRA,DF,Palmeiras,19,2002,7.2,17,9,9,6,2,6,10,60.0,4,2,1,1,18,35,11,0,Matches,bd8432ff
705,Guillermo Varela,uy URU,DF,Flamengo,28,1993,2.9,6,4,3,3,0,3,3,100.0,0,1,1,0,8,14,7,0,Matches,5c961282
706,Eduardo Vargas,cl CHI,FW,Atlético Mineiro,32,1989,12.7,6,6,2,2,2,3,9,33.3,6,11,0,11,4,10,8,0,Matches,bd603c00
707,Matheus de Vargas,br BRA,MF,Fortaleza,25,1996,4.6,6,2,1,5,0,3,12,25.0,9,4,1,3,3,9,3,0,Matches,e43a07d4
708,Jhon Vasquez,co COL,FWMF,Ceará,26,1995,4.6,7,5,2,5,0,5,10,50.0,5,4,0,4,1,8,3,0,Matches,b6832e5e
709,Rafael Vaz,br BRA,DF,Avaí,33,1988,15.5,17,9,14,3,0,12,23,52.2,11,16,12,4,12,29,69,0,Matches,244fc074
710,Raphael Veiga,br BRA,MF,Palmeiras,26,1995,14.0,14,10,2,9,3,7,17,41.2,10,6,0,6,3,17,6,0,Matches,6e5a3bc7
711,Emiliano Velázquez,uy URU,DF,Santos,27,1994,6.0,11,9,8,3,0,6,12,50.0,6,5,3,2,14,25,22,0,Matches,5efb80d5
712,Fausto Vera,ar ARG,MF,Corinthians,21,2000,14.5,37,22,19,14,4,18,37,48.6,19,23,11,12,18,55,26,1,Matches,8b3b381b
713,Gabriel Veron,br BRA,FWMF,Palmeiras,19,2002,6.3,14,8,8,6,0,10,12,83.3,2,4,0,4,6,20,3,0,Matches,6bc49da7
714,João Vialle,br BRA,DF,Atl Paranaense,19,2002,0.3,0,0,0,0,0,0,0,,0,0,0,0,0,0,0,0,Matches,c63a8bf0
715,João Victor,br BRA,MF,Ceará,17,2004,0.2,0,0,0,0,0,0,2,0.0,2,0,0,0,0,0,0,0,Matches,e78d763e
716,João Victor,br BRA,DF,Corinthians,23,1998,5.4,7,2,6,1,0,2,5,40.0,3,2,1,1,11,18,34,0,Matches,d60cf08d
717,Marcos Victor,br BRA,DF,Ceará,20,2001,4.0,7,4,7,0,0,6,6,100.0,0,4,3,1,8,15,14,1,Matches,d714fc5a
718,Arturo Vidal,cl CHI,MF,Flamengo,34,1987,9.3,23,16,8,10,5,13,27,48.1,14,11,1,10,21,44,7,0,Matches,67cdbc0e
719,Caio Vidal,br BRA,FWMF,Internacional,21,2000,1.7,3,2,2,0,1,2,5,40.0,3,0,0,0,3,6,1,0,Matches,599ab970
720,Elvis Vieira Araújo,br BRA,MFFW,Goiás,31,1990,9.4,6,4,3,2,1,3,17,17.6,14,3,0,3,6,12,1,0,Matches,b5391b63
721,Gabriel Vieira,br BRA,FW,Palmeiras,19,2002,0.1,0,0,0,0,0,0,0,,0,0,0,0,0,0,0,0,Matches,63904ba9
722,Luan Vieira,br BRA,MFFW,Santos,28,1993,5.0,5,4,1,3,1,3,8,37.5,5,5,3,2,1,6,0,0,Matches,c4f6bf06
723,Marcos Vinicios Sorriso,br BRA,FW,Bragantino,20,2001,15.0,25,15,12,9,4,11,24,45.8,13,24,4,20,8,33,13,0,Matches,e816a8ee
724,Vinícius,br BRA,FWMF,Ceará,30,1991,26.7,8,3,2,3,3,2,26,7.7,24,5,0,5,24,32,10,0,Matches,ee01c84d
725,Vinicius,br BRA,MFDF,Santos,22,1999,0.8,2,1,1,1,0,2,3,66.7,1,3,2,1,1,3,2,0,Matches,ab3ef9c4
726,Vinícius,br BRA,MFFW,Goiás,28,1993,21.7,18,14,3,7,8,9,27,33.3,18,20,5,15,14,32,19,0,Matches,b6bd2b80
727,Vinícius,br BRA,FW,Botafogo (RJ),22,1999,9.7,20,10,7,10,3,7,20,35.0,13,15,2,13,11,31,8,0,Matches,ecce7383
728,Caio Vinícius,br BRA,MF,Goiás,23,1999,17.3,45,23,16,20,9,12,35,34.3,23,25,3,22,30,75,41,0,Matches,8529df9f
729,Mateus Vital,br BRA,FWMF,Corinthians,23,1998,8.2,21,13,7,8,6,7,18,38.9,11,3,1,2,7,28,1,0,Matches,db9c8fa4
730,Vitão,br BRA,DF,Internacional,21,2000,31.0,32,14,25,7,0,22,31,71.0,9,39,30,9,19,51,161,0,Matches,d4f034db
731,Vitinho,br BRA,FW,Atl Paranaense,22,1999,15.9,22,11,5,11,6,10,29,34.5,19,11,0,11,5,27,13,0,Matches,06d4b2e4
732,Vitinho,br BRA,FWMF,Flamengo,28,1993,5.3,9,6,4,3,2,3,8,37.5,5,5,1,4,1,10,5,0,Matches,a9e68c94
733,Vitinho,br BRA,FWMF,Avaí,21,2000,4.0,3,1,1,2,0,1,3,33.3,2,1,0,1,1,4,1,0,Matches,5e5cc7a9
734,João Vitor,br BRA,MF,Coritiba,21,2000,0.1,0,0,0,0,0,0,0,,0,0,0,0,0,0,0,0,Matches,b8d3d5ee
735,Vladimir,br BRA,GK,Avaí,32,1989,22.5,2,0,2,0,0,2,2,100.0,0,0,0,0,0,2,7,0,Matches,bbae502c
736,Max Walef,br BRA,GK,Fortaleza,28,1993,5.0,0,0,0,0,0,0,0,,0,0,0,0,0,0,3,1,Matches,6411a48d
737,Walter,br BRA,GK,Cuiabá,34,1987,27.4,2,2,2,0,0,2,2,100.0,0,0,0,0,1,3,10,0,Matches,8bae322b
738,Wanderson,br BRA,DF,Atl Goianiense,30,1991,27.2,16,10,11,4,1,6,10,60.0,4,36,26,10,22,38,121,1,Matches,f612025c
739,Wanderson,br BRA,FWMF,Internacional,27,1994,17.8,15,9,4,7,4,8,19,42.1,11,8,0,8,3,18,8,0,Matches,5da33b33
740,Warley,br BRA,FWMF,Coritiba,22,1999,6.2,5,4,3,2,0,3,8,37.5,5,3,1,2,9,14,12,0,Matches,8f385e2e
741,Welington,br BRA,DFFW,São Paulo,20,2001,18.6,34,21,20,9,5,14,35,40.0,21,15,1,14,15,49,36,0,Matches,a7f95b1f
742,José Welison,br BRA,MF,Fortaleza,26,1995,19.1,37,22,12,20,5,13,27,48.1,14,24,6,18,38,75,29,0,Matches,b6cb4d16
743,Weliton,cl CHI,MF,Juventude,16,2005,0.0,0,0,0,0,0,0,0,,0,0,0,0,0,0,1,0,Matches,721322fb
744,Wellington,br BRA,DF,Avaí,26,1995,3.0,2,2,2,0,0,2,4,50.0,2,3,2,1,5,7,15,0,Matches,ed36f825
745,Welliton,br BRA,MFFW,Bragantino,21,2000,1.1,5,3,0,2,3,3,6,50.0,3,1,0,1,0,5,1,0,Matches,d1a7e953
746,Wendell,br BRA,MF,Ceará,19,2002,0.1,1,1,0,0,1,0,0,,0,0,0,0,1,2,1,0,Matches,82b7e058
747,Werik,br BRA,FW,Bragantino,20,2001,5.7,2,2,1,1,0,1,2,50.0,1,9,0,9,0,2,6,0,Matches,8b20ba5f
748,Werton,br BRA,FW,Flamengo,18,2003,0.3,3,1,1,0,2,2,2,100.0,0,0,0,0,0,3,2,0,Matches,d07bde9d
749,Wescley,br BRA,MF,Ceará,30,1991,0.8,3,2,2,1,0,1,2,50.0,1,0,0,0,0,3,0,0,Matches,5a43c680
750,Wesley,br BRA,FW,Palmeiras,22,1999,7.2,9,6,4,1,4,4,8,50.0,4,5,0,5,3,12,5,0,Matches,434de3a3
751,Weverson,br BRA,MF,Bragantino,21,2000,0.5,0,0,0,0,0,0,0,,0,0,0,0,0,0,0,0,Matches,b9829bf7
752,Weverton,br BRA,DF,Internacional,22,1999,0.5,0,0,0,0,0,0,0,,0,2,1,1,0,0,1,0,Matches,6ae59cc2
753,Wéverton,br BRA,GK,Palmeiras,34,1987,34.0,1,1,1,0,0,1,3,33.3,2,0,0,0,1,2,9,0,Matches,81be82e9
754,Rafael William,br BRA,GK,Coritiba,20,2001,6.0,0,0,0,0,0,0,0,,0,0,0,0,0,0,3,1,Matches,eb9f6c10
755,Willian,br BRA,FWMF,Fluminense,35,1986,5.3,8,5,2,5,1,3,7,42.9,4,8,0,8,8,16,6,0,Matches,1f85d0c8
756,Willian,br BRA,FW,Corinthians,33,1988,9.2,15,10,2,10,3,7,11,63.6,4,5,1,4,8,23,5,0,Matches,8b9ebd03
757,Xavier,br BRA,MF,Corinthians,21,2000,1.8,3,1,2,1,0,3,4,75.0,1,0,0,0,2,5,9,0,Matches,f16ed217
758,Samuel Xavier,br BRA,DF,Fluminense,31,1990,31.4,32,16,18,11,3,20,36,55.6,16,34,8,26,26,58,58,0,Matches,0c870df5
759,Yago,br BRA,MFDF,Fluminense,26,1995,12.6,22,13,6,13,3,15,23,65.2,8,20,6,14,13,35,12,0,Matches,e2add0e7
760,Ytalo,br BRA,FW,Bragantino,34,1988,6.9,3,3,0,1,2,1,4,25.0,3,7,1,6,3,6,5,0,Matches,423e3d0b
761,Marcos Ytalo,br BRA,DF,Ceará,25,1996,1.8,4,3,2,2,0,0,2,0.0,2,1,0,1,2,6,2,0,Matches,70053afc
762,Vinícius Zanocelo,br BRA,MF,Santos,21,2001,22.3,29,17,13,14,2,10,46,21.7,36,28,8,20,24,53,36,0,Matches,27457e83
763,Federico Zaracho,ar ARG,MFFW,Atlético Mineiro,23,1998,20.9,52,29,19,22,11,20,62,32.3,42,33,2,31,22,74,17,0,Matches,803d5265